시간대,공연건수,상연횟수,취소수,총 티켓판매수,총 티켓판매액,예매수,날짜,시간대_그룹,시간대_대분류
00:00 ~ 2:59,0,0,0,0,0,0,20230101,0-3,심야
3:00 ~ 5:59,0,0,0,0,0,0,20230101,3-6,심야
6:00 ~ 8:59,0,0,0,0,0,0,20230101,6-9,심야
9:00 ~ 11:59,542,542,855,2498,78778010,3353,20230101,9-12,주간
12:00 ~ 14:59,1157,1157,7047,4257,385985603,11304,20230101,12-15,주간
15:00 ~ 17:59,1078,1078,3490,6183,296267608,9673,20230101,15-18,주간
18:00 ~ 20:59,1557,1557,7500,9338,687706433,16838,20230101,18-21,저녁
21:00 ~ 23:59,11,11,7,14,317500,21,20230101,21-24,저녁
합계,4345,4345,18899,22290,1449055154,41189,20230101,,
00:00 ~ 2:59,0,0,0,0,0,0,20230102,0-3,심야
3:00 ~ 5:59,0,0,0,0,0,0,20230102,3-6,심야
6:00 ~ 8:59,0,0,0,0,0,0,20230102,6-9,심야
9:00 ~ 11:59,680,680,1504,3673,102819140,5177,20230102,9-12,주간
12:00 ~ 14:59,1207,1207,4334,6717,362799968,11051,20230102,12-15,주간
15:00 ~ 17:59,1145,1145,3169,6275,252380010,9444,20230102,15-18,주간
18:00 ~ 20:59,1679,1679,13020,11584,657819039,24604,20230102,18-21,저녁
21:00 ~ 23:59,11,11,15,27,-13300,42,20230102,21-24,저녁
합계,4722,4722,22042,28276,1375804857,50318,20230102,,
00:00 ~ 2:59,0,0,0,0,0,0,20230103,0-3,심야
3:00 ~ 5:59,0,0,0,0,0,0,20230103,3-6,심야
6:00 ~ 8:59,0,0,0,0,0,0,20230103,6-9,심야
9:00 ~ 11:59,699,699,1843,3893,98291990,5736,20230103,9-12,주간
12:00 ~ 14:59,1305,1305,4640,8362,392737430,13002,20230103,12-15,주간
15:00 ~ 17:59,1155,1155,4593,6367,244544350,10960,20230103,15-18,주간
18:00 ~ 20:59,1764,1764,13939,15941,891309427,29880,20230103,18-21,저녁
21:00 ~ 23:59,15,15,48,8,-2027900,56,20230103,21-24,저녁
합계,4938,4938,25063,34571,1624855297,59634,20230103,,
00:00 ~ 2:59,0,0,0,0,0,0,20230104,0-3,심야
3:00 ~ 5:59,0,0,0,0,0,0,20230104,3-6,심야
6:00 ~ 8:59,0,0,0,0,0,0,20230104,6-9,심야
9:00 ~ 11:59,653,653,1952,5891,118535000,7843,20230104,9-12,주간
12:00 ~ 14:59,1311,1311,6551,10798,480814810,17349,20230104,12-15,주간
15:00 ~ 17:59,1169,1169,4092,8643,328795680,12735,20230104,15-18,주간
18:00 ~ 20:59,1775,1775,17520,18811,1177247019,36331,20230104,18-21,저녁
21:00 ~ 23:59,16,16,12,47,1576100,59,20230104,21-24,저녁
합계,4924,4924,30127,44190,2106968609,74317,20230104,,
00:00 ~ 2:59,0,0,0,0,0,0,20230105,0-3,심야
3:00 ~ 5:59,0,0,0,0,0,0,20230105,3-6,심야
6:00 ~ 8:59,0,0,0,0,0,0,20230105,6-9,심야
9:00 ~ 11:59,738,738,2849,4894,116175210,7743,20230105,9-12,주간
12:00 ~ 14:59,1336,1336,6996,13258,874450970,20254,20230105,12-15,주간
15:00 ~ 17:59,1211,1211,5865,9518,408284900,15383,20230105,15-18,주간
18:00 ~ 20:59,1884,1884,20074,31710,1972610390,51784,20230105,18-21,저녁
21:00 ~ 23:59,10,10,10,32,1106600,42,20230105,21-24,저녁
합계,5179,5179,35794,59412,3372628070,95206,20230105,,
00:00 ~ 2:59,0,0,0,0,0,0,20230106,0-3,심야
3:00 ~ 5:59,0,0,0,0,0,0,20230106,3-6,심야
6:00 ~ 8:59,0,0,0,0,0,0,20230106,6-9,심야
9:00 ~ 11:59,745,745,4021,10004,121128890,14025,20230106,9-12,주간
12:00 ~ 14:59,1393,1393,8610,14902,673830970,23512,20230106,12-15,주간
15:00 ~ 17:59,1228,1228,4615,11201,318545870,15816,20230106,15-18,주간
18:00 ~ 20:59,1794,1794,16020,18305,1202974060,34325,20230106,18-21,저녁
21:00 ~ 23:59,13,13,12,80,2105400,92,20230106,21-24,저녁
합계,5173,5173,33278,54492,2318585190,87770,20230106,,
00:00 ~ 2:59,0,0,0,0,0,0,20230107,0-3,심야
3:00 ~ 5:59,0,0,0,0,0,0,20230107,3-6,심야
6:00 ~ 8:59,0,0,0,0,0,0,20230107,6-9,심야
9:00 ~ 11:59,639,639,1347,3949,107017140,5296,20230107,9-12,주간
12:00 ~ 14:59,1322,1322,6348,9415,526039242,15763,20230107,12-15,주간
15:00 ~ 17:59,1174,1174,3366,8967,315812208,12333,20230107,15-18,주간
18:00 ~ 20:59,1609,1609,10896,10070,810387520,20966,20230107,18-21,저녁
21:00 ~ 23:59,11,11,7,58,1062740,65,20230107,21-24,저녁
합계,4755,4755,21964,32459,1760318850,54423,20230107,,
00:00 ~ 2:59,0,0,0,0,0,0,20230108,0-3,심야
3:00 ~ 5:59,0,0,0,0,0,0,20230108,3-6,심야
6:00 ~ 8:59,0,0,0,0,0,0,20230108,6-9,심야
9:00 ~ 11:59,622,622,1116,3756,99205000,4872,20230108,9-12,주간
12:00 ~ 14:59,1242,1242,6665,7662,452948950,14327,20230108,12-15,주간
15:00 ~ 17:59,1095,1095,2999,7602,302583360,10601,20230108,15-18,주간
18:00 ~ 20:59,1549,1549,8739,8029,724504890,16768,20230108,18-21,저녁
21:00 ~ 23:59,10,10,14,16,433100,30,20230108,21-24,저녁
합계,4518,4518,19533,27065,1579675300,46598,20230108,,
00:00 ~ 2:59,0,0,0,0,0,0,20230109,0-3,심야
3:00 ~ 5:59,0,0,0,0,0,0,20230109,3-6,심야
6:00 ~ 8:59,1,1,27,5,770000,32,20230109,6-9,심야
9:00 ~ 11:59,629,629,1297,4220,98827500,5517,20230109,9-12,주간
12:00 ~ 14:59,1239,1239,5976,8018,445903190,13994,20230109,12-15,주간
15:00 ~ 17:59,1121,1121,3872,12101,831246160,15973,20230109,15-18,주간
18:00 ~ 20:59,1785,1785,16282,17462,1225954690,33744,20230109,18-21,저녁
21:00 ~ 23:59,11,11,19,18,518400,37,20230109,21-24,저녁
합계,4786,4786,27473,41824,2603219940,69297,20230109,,
00:00 ~ 2:59,0,0,0,0,0,0,20230110,0-3,심야
3:00 ~ 5:59,0,0,0,0,0,0,20230110,3-6,심야
6:00 ~ 8:59,1,1,1,-1,-154000,0,20230110,6-9,심야
9:00 ~ 11:59,717,717,6094,2347,151251270,8441,20230110,9-12,주간
12:00 ~ 14:59,1338,1338,9389,7488,475961904,16877,20230110,12-15,주간
15:00 ~ 17:59,1203,1203,6781,12611,683370640,19392,20230110,15-18,주간
18:00 ~ 20:59,1898,1898,14910,19649,994042670,34559,20230110,18-21,저녁
21:00 ~ 23:59,12,12,18,10,149400,28,20230110,21-24,저녁
합계,5169,5169,37193,42104,2304621884,79297,20230110,,
00:00 ~ 2:59,0,0,0,0,0,0,20230111,0-3,심야
3:00 ~ 5:59,0,0,0,0,0,0,20230111,3-6,심야
6:00 ~ 8:59,1,1,4,-4,-616000,0,20230111,6-9,심야
9:00 ~ 11:59,731,731,2000,6504,123540500,8504,20230111,9-12,주간
12:00 ~ 14:59,1384,1384,8066,15162,988139200,23228,20230111,12-15,주간
15:00 ~ 17:59,1248,1248,5292,10910,441154140,16202,20230111,15-18,주간
18:00 ~ 20:59,1922,1922,16573,27775,1427322220,44348,20230111,18-21,저녁
21:00 ~ 23:59,11,11,4,33,687100,37,20230111,21-24,저녁
합계,5297,5297,31939,60380,2980227160,92319,20230111,,
00:00 ~ 2:59,0,0,0,0,0,0,20230112,0-3,심야
3:00 ~ 5:59,0,0,0,0,0,0,20230112,3-6,심야
6:00 ~ 8:59,0,0,0,0,0,0,20230112,6-9,심야
9:00 ~ 11:59,730,730,2700,4374,129795140,7074,20230112,9-12,주간
12:00 ~ 14:59,1373,1373,6172,12383,729637530,18555,20230112,12-15,주간
15:00 ~ 17:59,1228,1228,4470,9381,356177930,13851,20230112,15-18,주간
18:00 ~ 20:59,1922,1922,14119,25259,1461534930,39378,20230112,18-21,저녁
21:00 ~ 23:59,14,14,7,52,837900,59,20230112,21-24,저녁
합계,5267,5267,27468,51449,2677983430,78917,20230112,,
00:00 ~ 2:59,0,0,0,0,0,0,20230113,0-3,심야
3:00 ~ 5:59,0,0,0,0,0,0,20230113,3-6,심야
6:00 ~ 8:59,0,0,0,0,0,0,20230113,6-9,심야
9:00 ~ 11:59,677,677,2403,4007,96017260,6410,20230113,9-12,주간
12:00 ~ 14:59,1422,1422,6796,11849,595912600,18645,20230113,12-15,주간
15:00 ~ 17:59,1326,1326,4182,12600,359874510,16782,20230113,15-18,주간
18:00 ~ 20:59,1937,1937,15472,23101,1304518920,38573,20230113,18-21,저녁
21:00 ~ 23:59,13,13,2,53,708950,55,20230113,21-24,저녁
합계,5375,5375,28855,51610,2357032240,80465,20230113,,
00:00 ~ 2:59,0,0,0,0,0,0,20230114,0-3,심야
3:00 ~ 5:59,0,0,0,0,0,0,20230114,3-6,심야
6:00 ~ 8:59,0,0,0,0,0,0,20230114,6-9,심야
9:00 ~ 11:59,664,664,1421,3971,105529280,5392,20230114,9-12,주간
12:00 ~ 14:59,1383,1383,6616,15356,559895260,21972,20230114,12-15,주간
15:00 ~ 17:59,1226,1226,3803,10185,347065260,13988,20230114,15-18,주간
18:00 ~ 20:59,1753,1753,13422,22505,905429360,35927,20230114,18-21,저녁
21:00 ~ 23:59,10,10,9,24,226700,33,20230114,21-24,저녁
합계,5036,5036,25271,52041,1918145860,77312,20230114,,
00:00 ~ 2:59,0,0,0,0,0,0,20230115,0-3,심야
3:00 ~ 5:59,0,0,0,0,0,0,20230115,3-6,심야
6:00 ~ 8:59,0,0,0,0,0,0,20230115,6-9,심야
9:00 ~ 11:59,617,617,1073,3115,86883560,4188,20230115,9-12,주간
12:00 ~ 14:59,1325,1325,6211,7807,463897720,14018,20230115,12-15,주간
15:00 ~ 17:59,1131,1131,4770,6182,308830370,10952,20230115,15-18,주간
18:00 ~ 20:59,1668,1668,9530,8767,744313250,18297,20230115,18-21,저녁
21:00 ~ 23:59,11,11,6,28,679100,34,20230115,21-24,저녁
합계,4752,4752,21590,25899,1604604000,47489,20230115,,
00:00 ~ 2:59,0,0,0,0,0,0,20230116,0-3,심야
3:00 ~ 5:59,0,0,0,0,0,0,20230116,3-6,심야
6:00 ~ 8:59,0,0,0,0,0,0,20230116,6-9,심야
9:00 ~ 11:59,654,654,1545,3634,86889110,5179,20230116,9-12,주간
12:00 ~ 14:59,1269,1269,4805,8096,418178300,12901,20230116,12-15,주간
15:00 ~ 17:59,1119,1119,3674,8185,405515050,11859,20230116,15-18,주간
18:00 ~ 20:59,1773,1773,12448,19567,1138618770,32015,20230116,18-21,저녁
21:00 ~ 23:59,9,9,5,23,632200,28,20230116,21-24,저녁
합계,4824,4824,22477,39505,2049833430,61982,20230116,,
00:00 ~ 2:59,0,0,0,0,0,0,20230117,0-3,심야
3:00 ~ 5:59,0,0,0,0,0,0,20230117,3-6,심야
6:00 ~ 8:59,0,0,0,0,0,0,20230117,6-9,심야
9:00 ~ 11:59,683,683,3146,5444,132080810,8590,20230117,9-12,주간
12:00 ~ 14:59,1322,1322,7018,11905,860345939,18923,20230117,12-15,주간
15:00 ~ 17:59,1226,1226,4178,11794,517386850,15972,20230117,15-18,주간
18:00 ~ 20:59,1993,1993,18991,28860,2038393309,47851,20230117,18-21,저녁
21:00 ~ 23:59,8,8,8,39,397500,47,20230117,21-24,저녁
합계,5232,5232,33341,58042,3548604408,91383,20230117,,
00:00 ~ 2:59,0,0,0,0,0,0,20230118,0-3,심야
3:00 ~ 5:59,0,0,0,0,0,0,20230118,3-6,심야
6:00 ~ 8:59,0,0,0,0,0,0,20230118,6-9,심야
9:00 ~ 11:59,705,705,2236,4022,121453550,6258,20230118,9-12,주간
12:00 ~ 14:59,1347,1347,8018,11404,1016425540,19422,20230118,12-15,주간
15:00 ~ 17:59,1235,1235,5241,10333,618639110,15574,20230118,15-18,주간
18:00 ~ 20:59,1960,1960,19896,26507,2587525730,46403,20230118,18-21,저녁
21:00 ~ 23:59,9,9,20,32,372000,52,20230118,21-24,저녁
합계,5256,5256,35411,52298,4344415930,87709,20230118,,
00:00 ~ 2:59,0,0,0,0,0,0,20230119,0-3,심야
3:00 ~ 5:59,0,0,0,0,0,0,20230119,3-6,심야
6:00 ~ 8:59,0,0,0,0,0,0,20230119,6-9,심야
9:00 ~ 11:59,655,655,2599,4780,121166640,7379,20230119,9-12,주간
12:00 ~ 14:59,1314,1314,9305,15082,1168674250,24387,20230119,12-15,주간
15:00 ~ 17:59,1243,1243,4245,10080,503375810,14325,20230119,15-18,주간
18:00 ~ 20:59,1964,1964,22583,27403,2262231490,49986,20230119,18-21,저녁
21:00 ~ 23:59,9,9,0,42,590700,42,20230119,21-24,저녁
합계,5185,5185,38732,57387,4056038890,96119,20230119,,
00:00 ~ 2:59,0,0,0,0,0,0,20230120,0-3,심야
3:00 ~ 5:59,0,0,0,0,0,0,20230120,3-6,심야
6:00 ~ 8:59,0,0,0,0,0,0,20230120,6-9,심야
9:00 ~ 11:59,633,633,1693,4638,88697950,6331,20230120,9-12,주간
12:00 ~ 14:59,1333,1333,8144,11800,827849287,19944,20230120,12-15,주간
15:00 ~ 17:59,1255,1255,4366,9301,392131300,13667,20230120,15-18,주간
18:00 ~ 20:59,1914,1914,18376,18695,1546996990,37071,20230120,18-21,저녁
21:00 ~ 23:59,6,6,16,37,927900,53,20230120,21-24,저녁
합계,5141,5141,32595,44471,2856603427,77066,20230120,,
00:00 ~ 2:59,0,0,0,0,0,0,20230121,0-3,심야
3:00 ~ 5:59,0,0,0,0,0,0,20230121,3-6,심야
6:00 ~ 8:59,0,0,0,0,0,0,20230121,6-9,심야
9:00 ~ 11:59,534,534,1317,2449,76163650,3766,20230121,9-12,주간
12:00 ~ 14:59,1231,1231,7976,7586,605623940,15562,20230121,12-15,주간
15:00 ~ 17:59,1180,1180,3403,7420,304365710,10823,20230121,15-18,주간
18:00 ~ 20:59,1765,1765,11382,10300,993872062,21682,20230121,18-21,저녁
21:00 ~ 23:59,7,7,2,38,743400,40,20230121,21-24,저녁
합계,4717,4717,24080,27793,1980768762,51873,20230121,,
00:00 ~ 2:59,0,0,0,0,0,0,20230122,0-3,심야
3:00 ~ 5:59,0,0,0,0,0,0,20230122,3-6,심야
6:00 ~ 8:59,0,0,0,0,0,0,20230122,6-9,심야
9:00 ~ 11:59,484,484,964,2560,74831190,3524,20230122,9-12,주간
12:00 ~ 14:59,1139,1139,5868,7352,488913101,13220,20230122,12-15,주간
15:00 ~ 17:59,1119,1119,2852,6452,258054750,9304,20230122,15-18,주간
18:00 ~ 20:59,1670,1670,8487,7785,754566210,16272,20230122,18-21,저녁
21:00 ~ 23:59,8,8,0,17,612200,17,20230122,21-24,저녁
합계,4420,4420,18171,24166,1576977451,42337,20230122,,
00:00 ~ 2:59,0,0,0,0,0,0,20230123,0-3,심야
3:00 ~ 5:59,0,0,0,0,0,0,20230123,3-6,심야
6:00 ~ 8:59,0,0,0,0,0,0,20230123,6-9,심야
9:00 ~ 11:59,539,539,1346,3185,84217680,4531,20230123,9-12,주간
12:00 ~ 14:59,1170,1170,6539,7925,460154458,14464,20230123,12-15,주간
15:00 ~ 17:59,1109,1109,3715,6150,263768467,9865,20230123,15-18,주간
18:00 ~ 20:59,1686,1686,7839,8607,687908942,16446,20230123,18-21,저녁
21:00 ~ 23:59,8,8,4,38,724000,42,20230123,21-24,저녁
합계,4512,4512,19443,25905,1496773547,45348,20230123,,
00:00 ~ 2:59,0,0,0,0,0,0,20230124,0-3,심야
3:00 ~ 5:59,0,0,0,0,0,0,20230124,3-6,심야
6:00 ~ 8:59,0,0,0,0,0,0,20230124,6-9,심야
9:00 ~ 11:59,604,604,1639,2688,83424880,4327,20230124,9-12,주간
12:00 ~ 14:59,1222,1222,6615,7912,455291842,14527,20230124,12-15,주간
15:00 ~ 17:59,1167,1167,3055,5745,218771419,8800,20230124,15-18,주간
18:00 ~ 20:59,1704,1704,10839,8277,579635220,19116,20230124,18-21,저녁
21:00 ~ 23:59,7,7,3,41,720100,44,20230124,21-24,저녁
합계,4704,4704,22151,24663,1337843461,46814,20230124,,
00:00 ~ 2:59,0,0,0,0,0,0,20230125,0-3,심야
3:00 ~ 5:59,0,0,0,0,0,0,20230125,3-6,심야
6:00 ~ 8:59,0,0,0,0,0,0,20230125,6-9,심야
9:00 ~ 11:59,636,636,2245,4821,136099990,7066,20230125,9-12,주간
12:00 ~ 14:59,1269,1269,5961,8861,438858640,14822,20230125,12-15,주간
15:00 ~ 17:59,1284,1284,4420,10087,258167520,14507,20230125,15-18,주간
18:00 ~ 20:59,1913,1913,14785,14442,758641240,29227,20230125,18-21,저녁
21:00 ~ 23:59,14,14,14,25,721400,39,20230125,21-24,저녁
합계,5116,5116,27425,38236,1592488790,65661,20230125,,
00:00 ~ 2:59,1,1,3,1,0,4,20230126,0-3,심야
3:00 ~ 5:59,0,0,0,0,0,0,20230126,3-6,심야
6:00 ~ 8:59,0,0,0,0,0,0,20230126,6-9,심야
9:00 ~ 11:59,683,683,2907,5138,132602270,8045,20230126,9-12,주간
12:00 ~ 14:59,1275,1275,7067,11191,839807962,18258,20230126,12-15,주간
15:00 ~ 17:59,1323,1323,3949,8975,241273400,12924,20230126,15-18,주간
18:00 ~ 20:59,1874,1874,13886,17668,1020747620,31554,20230126,18-21,저녁
21:00 ~ 23:59,9,9,4,26,544000,30,20230126,21-24,저녁
합계,5165,5165,27816,42999,2234975252,70815,20230126,,
00:00 ~ 2:59,0,0,0,0,0,0,20230127,0-3,심야
3:00 ~ 5:59,0,0,0,0,0,0,20230127,3-6,심야
6:00 ~ 8:59,0,0,0,0,0,0,20230127,6-9,심야
9:00 ~ 11:59,747,747,2888,5571,131049320,8459,20230127,9-12,주간
12:00 ~ 14:59,1389,1389,8420,11597,488674070,20017,20230127,12-15,주간
15:00 ~ 17:59,1367,1367,4904,15455,595167790,20359,20230127,15-18,주간
18:00 ~ 20:59,1882,1882,16919,17081,1087895100,34000,20230127,18-21,저녁
21:00 ~ 23:59,11,11,6,74,1460300,80,20230127,21-24,저녁
합계,5396,5396,33137,49778,2304246580,82915,20230127,,
00:00 ~ 2:59,0,0,0,0,0,0,20230128,0-3,심야
3:00 ~ 5:59,0,0,0,0,0,0,20230128,3-6,심야
6:00 ~ 8:59,0,0,0,0,0,0,20230128,6-9,심야
9:00 ~ 11:59,694,694,1955,5162,121910470,7117,20230128,9-12,주간
12:00 ~ 14:59,1368,1368,6318,11194,494643900,17512,20230128,12-15,주간
15:00 ~ 17:59,1342,1342,5078,12015,422373320,17093,20230128,15-18,주간
18:00 ~ 20:59,1714,1714,10622,12732,815701314,23354,20230128,18-21,저녁
21:00 ~ 23:59,10,10,7,77,1634000,84,20230128,21-24,저녁
합계,5128,5128,23980,41180,1856263004,65160,20230128,,
00:00 ~ 2:59,0,0,0,0,0,0,20230129,0-3,심야
3:00 ~ 5:59,0,0,0,0,0,0,20230129,3-6,심야
6:00 ~ 8:59,0,0,0,0,0,0,20230129,6-9,심야
9:00 ~ 11:59,696,696,1623,4427,116754040,6050,20230129,9-12,주간
12:00 ~ 14:59,1241,1241,6315,8308,435906970,14623,20230129,12-15,주간
15:00 ~ 17:59,1227,1227,4163,8591,310716220,12754,20230129,15-18,주간
18:00 ~ 20:59,1659,1659,8534,8415,713621962,16949,20230129,18-21,저녁
21:00 ~ 23:59,11,11,7,30,470500,37,20230129,21-24,저녁
합계,4834,4834,20642,29771,1577469692,50413,20230129,,
00:00 ~ 2:59,0,0,0,0,0,0,20230130,0-3,심야
3:00 ~ 5:59,0,0,0,0,0,0,20230130,3-6,심야
6:00 ~ 8:59,0,0,0,0,0,0,20230130,6-9,심야
9:00 ~ 11:59,686,686,1772,3555,106421120,5327,20230130,9-12,주간
12:00 ~ 14:59,1214,1214,4719,7744,421433324,12463,20230130,12-15,주간
15:00 ~ 17:59,1242,1242,3649,11988,681782490,15637,20230130,15-18,주간
18:00 ~ 20:59,1797,1797,11651,27455,1883709900,39106,20230130,18-21,저녁
21:00 ~ 23:59,10,10,12,24,595800,36,20230130,21-24,저녁
합계,4949,4949,21803,50766,3093942634,72569,20230130,,
00:00 ~ 2:59,0,0,0,0,0,0,20230131,0-3,심야
3:00 ~ 5:59,0,0,0,0,0,0,20230131,3-6,심야
6:00 ~ 8:59,0,0,0,0,0,0,20230131,6-9,심야
9:00 ~ 11:59,693,693,3824,6363,149949840,10187,20230131,9-12,주간
12:00 ~ 14:59,1291,1291,8264,11476,590043122,19740,20230131,12-15,주간
15:00 ~ 17:59,1304,1304,4603,10639,521269960,15242,20230131,15-18,주간
18:00 ~ 20:59,1897,1897,16039,22361,1234444472,38400,20230131,18-21,저녁
21:00 ~ 23:59,16,16,12,55,1401200,67,20230131,21-24,저녁
합계,5201,5201,32742,50894,2497108594,83636,20230131,,
00:00 ~ 2:59,0,0,0,0,0,0,20230201,0-3,심야
3:00 ~ 5:59,0,0,0,0,0,0,20230201,3-6,심야
6:00 ~ 8:59,0,0,0,0,0,0,20230201,6-9,심야
9:00 ~ 11:59,729,729,2922,6193,169408970,9115,20230201,9-12,주간
12:00 ~ 14:59,1386,1386,7306,11675,713831352,18981,20230201,12-15,주간
15:00 ~ 17:59,1366,1366,4911,11042,552885730,15953,20230201,15-18,주간
18:00 ~ 20:59,2020,2020,15444,22808,1456849410,38252,20230201,18-21,저녁
21:00 ~ 23:59,17,17,2,72,1674900,74,20230201,21-24,저녁
합계,5518,5518,30585,51790,2894650362,82375,20230201,,
00:00 ~ 2:59,0,0,0,0,0,0,20230202,0-3,심야
3:00 ~ 5:59,0,0,0,0,0,0,20230202,3-6,심야
6:00 ~ 8:59,0,0,0,0,0,0,20230202,6-9,심야
9:00 ~ 11:59,749,749,2300,5709,197662872,8009,20230202,9-12,주간
12:00 ~ 14:59,1386,1386,6724,12394,599792495,19118,20230202,12-15,주간
15:00 ~ 17:59,1393,1393,5504,11195,563930206,16699,20230202,15-18,주간
18:00 ~ 20:59,1996,1996,16794,21601,1202665905,38395,20230202,18-21,저녁
21:00 ~ 23:59,7,7,0,25,587300,25,20230202,21-24,저녁
합계,5531,5531,31322,50924,2564638778,82246,20230202,,
00:00 ~ 2:59,0,0,0,0,0,0,20230203,0-3,심야
3:00 ~ 5:59,0,0,0,0,0,0,20230203,3-6,심야
6:00 ~ 8:59,0,0,0,0,0,0,20230203,6-9,심야
9:00 ~ 11:59,732,732,2231,5816,154037290,8047,20230203,9-12,주간
12:00 ~ 14:59,1381,1381,6793,11777,522601216,18570,20230203,12-15,주간
15:00 ~ 17:59,1441,1441,6215,13491,543462316,19706,20230203,15-18,주간
18:00 ~ 20:59,1988,1988,18207,26024,1900732420,44231,20230203,18-21,저녁
21:00 ~ 23:59,11,11,3,31,589200,34,20230203,21-24,저녁
합계,5553,5553,33449,57139,3121422442,90588,20230203,,
00:00 ~ 2:59,0,0,0,0,0,0,20230204,0-3,심야
3:00 ~ 5:59,0,0,0,0,0,0,20230204,3-6,심야
6:00 ~ 8:59,0,0,0,0,0,0,20230204,6-9,심야
9:00 ~ 11:59,679,679,2262,6083,130423710,8345,20230204,9-12,주간
12:00 ~ 14:59,1383,1383,8890,8136,443307768,17026,20230204,12-15,주간
15:00 ~ 17:59,1330,1330,5326,10715,388776460,16041,20230204,15-18,주간
18:00 ~ 20:59,1778,1778,14323,11660,881527160,25983,20230204,18-21,저녁
21:00 ~ 23:59,16,16,15,42,752500,57,20230204,21-24,저녁
합계,5186,5186,30816,36636,1844787598,67452,20230204,,
00:00 ~ 2:59,0,0,0,0,0,0,20230205,0-3,심야
3:00 ~ 5:59,0,0,0,0,0,0,20230205,3-6,심야
6:00 ~ 8:59,0,0,0,0,0,0,20230205,6-9,심야
9:00 ~ 11:59,676,676,1607,4098,111192320,5705,20230205,9-12,주간
12:00 ~ 14:59,1287,1287,7237,6872,399962880,14109,20230205,12-15,주간
15:00 ~ 17:59,1288,1288,3892,8790,307969210,12682,20230205,15-18,주간
18:00 ~ 20:59,1727,1727,9896,7292,610192156,17188,20230205,18-21,저녁
21:00 ~ 23:59,12,12,21,15,284600,36,20230205,21-24,저녁
합계,4990,4990,22653,27067,1429601166,49720,20230205,,
00:00 ~ 2:59,0,0,0,0,0,0,20230206,0-3,심야
3:00 ~ 5:59,0,0,0,0,0,0,20230206,3-6,심야
6:00 ~ 8:59,0,0,0,0,0,0,20230206,6-9,심야
9:00 ~ 11:59,666,666,1495,3857,120314700,5352,20230206,9-12,주간
12:00 ~ 14:59,1259,1259,5833,11040,787308900,16873,20230206,12-15,주간
15:00 ~ 17:59,1275,1275,4493,10178,415867910,14671,20230206,15-18,주간
18:00 ~ 20:59,1848,1848,16414,16532,1170018252,32946,20230206,18-21,저녁
21:00 ~ 23:59,11,11,11,24,413000,35,20230206,21-24,저녁
합계,5059,5059,28246,41631,2493922762,69877,20230206,,
00:00 ~ 2:59,0,0,0,0,0,0,20230207,0-3,심야
3:00 ~ 5:59,0,0,0,0,0,0,20230207,3-6,심야
6:00 ~ 8:59,0,0,0,0,0,0,20230207,6-9,심야
9:00 ~ 11:59,718,718,2210,6047,149406220,8257,20230207,9-12,주간
12:00 ~ 14:59,1305,1305,9463,13609,1013729040,23072,20230207,12-15,주간
15:00 ~ 17:59,1333,1333,5932,13408,926696140,19340,20230207,15-18,주간
18:00 ~ 20:59,1926,1926,19993,23233,2120993000,43226,20230207,18-21,저녁
21:00 ~ 23:59,16,16,14,51,660700,65,20230207,21-24,저녁
합계,5298,5298,37612,56348,4211485100,93960,20230207,,
00:00 ~ 2:59,1,1,8,0,0,8,20230208,0-3,심야
3:00 ~ 5:59,0,0,0,0,0,0,20230208,3-6,심야
6:00 ~ 8:59,0,0,0,0,0,0,20230208,6-9,심야
9:00 ~ 11:59,719,719,1996,5356,123979490,7352,20230208,9-12,주간
12:00 ~ 14:59,1292,1292,6874,9144,581471314,16018,20230208,12-15,주간
15:00 ~ 17:59,1316,1316,4901,11402,387243790,16303,20230208,15-18,주간
18:00 ~ 20:59,1980,1980,17849,25445,1992838371,43294,20230208,18-21,저녁
21:00 ~ 23:59,11,11,23,503,21225200,526,20230208,21-24,저녁
합계,5319,5319,31651,51850,3106758165,83501,20230208,,
00:00 ~ 2:59,0,0,0,0,0,0,20230209,0-3,심야
3:00 ~ 5:59,0,0,0,0,0,0,20230209,3-6,심야
6:00 ~ 8:59,0,0,0,0,0,0,20230209,6-9,심야
9:00 ~ 11:59,694,694,2815,6131,153491380,8946,20230209,9-12,주간
12:00 ~ 14:59,1321,1321,6797,12591,560893934,19388,20230209,12-15,주간
15:00 ~ 17:59,1325,1325,8257,11738,337369790,19995,20230209,15-18,주간
18:00 ~ 20:59,2015,2015,19792,20566,1213425806,40358,20230209,18-21,저녁
21:00 ~ 23:59,9,9,16,37,1216420,53,20230209,21-24,저녁
합계,5364,5364,37677,51063,2266397330,88740,20230209,,
00:00 ~ 2:59,1,1,0,6,150000,6,20230210,0-3,심야
3:00 ~ 5:59,0,0,0,0,0,0,20230210,3-6,심야
6:00 ~ 8:59,0,0,0,0,0,0,20230210,6-9,심야
9:00 ~ 11:59,733,733,2335,6906,149150870,9241,20230210,9-12,주간
12:00 ~ 14:59,1341,1341,7619,14223,714069270,21842,20230210,12-15,주간
15:00 ~ 17:59,1380,1380,6343,11013,360628800,17356,20230210,15-18,주간
18:00 ~ 20:59,2013,2013,18392,22677,1282541010,41069,20230210,18-21,저녁
21:00 ~ 23:59,12,12,17,255,13853350,272,20230210,21-24,저녁
합계,5480,5480,34706,55080,2520393300,89786,20230210,,
00:00 ~ 2:59,1,1,3,6,150000,9,20230211,0-3,심야
3:00 ~ 5:59,0,0,0,0,0,0,20230211,3-6,심야
6:00 ~ 8:59,0,0,0,0,0,0,20230211,6-9,심야
9:00 ~ 11:59,684,684,1790,5022,128682020,6812,20230211,9-12,주간
12:00 ~ 14:59,1377,1377,7772,10034,501255548,17806,20230211,12-15,주간
15:00 ~ 17:59,1358,1358,7099,9857,275903140,16956,20230211,15-18,주간
18:00 ~ 20:59,1862,1862,12398,11838,746992678,24236,20230211,18-21,저녁
21:00 ~ 23:59,11,11,24,95,3990300,119,20230211,21-24,저녁
합계,5293,5293,29086,36852,1656973686,65938,20230211,,
00:00 ~ 2:59,2,2,0,13,325000,13,20230212,0-3,심야
3:00 ~ 5:59,0,0,0,0,0,0,20230212,3-6,심야
6:00 ~ 8:59,0,0,0,0,0,0,20230212,6-9,심야
9:00 ~ 11:59,675,675,1487,4262,109776520,5749,20230212,9-12,주간
12:00 ~ 14:59,1292,1292,7528,7040,417096580,14568,20230212,12-15,주간
15:00 ~ 17:59,1277,1277,4696,7953,262329630,12649,20230212,15-18,주간
18:00 ~ 20:59,1778,1778,9568,8633,631356860,18201,20230212,18-21,저녁
21:00 ~ 23:59,12,12,26,60,3566480,86,20230212,21-24,저녁
합계,5036,5036,23305,27961,1424451070,51266,20230212,,
00:00 ~ 2:59,2,2,2,15,375000,17,20230213,0-3,심야
3:00 ~ 5:59,0,0,0,0,0,0,20230213,3-6,심야
6:00 ~ 8:59,0,0,0,0,0,0,20230213,6-9,심야
9:00 ~ 11:59,635,635,1371,3918,98425200,5289,20230213,9-12,주간
12:00 ~ 14:59,1166,1166,4221,7841,315122160,12062,20230213,12-15,주간
15:00 ~ 17:59,1235,1235,6349,6514,63039410,12863,20230213,15-18,주간
18:00 ~ 20:59,1881,1881,12477,16466,753692986,28943,20230213,18-21,저녁
21:00 ~ 23:59,10,10,39,34,1879680,73,20230213,21-24,저녁
합계,4929,4929,24459,34788,1232534436,59247,20230213,,
00:00 ~ 2:59,3,3,2,12,275000,14,20230214,0-3,심야
3:00 ~ 5:59,0,0,0,0,0,0,20230214,3-6,심야
6:00 ~ 8:59,0,0,0,0,0,0,20230214,6-9,심야
9:00 ~ 11:59,689,689,1944,6434,152439080,8378,20230214,9-12,주간
12:00 ~ 14:59,1218,1218,8609,21807,2523520440,30416,20230214,12-15,주간
15:00 ~ 17:59,1296,1296,4784,10486,395248370,15270,20230214,15-18,주간
18:00 ~ 20:59,2038,2038,15060,26206,1972681530,41266,20230214,18-21,저녁
21:00 ~ 23:59,14,14,21,52,1238580,73,20230214,21-24,저녁
합계,5258,5258,30420,64997,5045403000,95417,20230214,,
00:00 ~ 2:59,2,2,0,8,200000,8,20230215,0-3,심야
3:00 ~ 5:59,0,0,0,0,0,0,20230215,3-6,심야
6:00 ~ 8:59,0,0,0,0,0,0,20230215,6-9,심야
9:00 ~ 11:59,716,716,1809,5707,132067170,7516,20230215,9-12,주간
12:00 ~ 14:59,1295,1295,6555,10181,660667512,16736,20230215,12-15,주간
15:00 ~ 17:59,1320,1320,4732,9997,363620670,14729,20230215,15-18,주간
18:00 ~ 20:59,2029,2029,14107,31261,2727535490,45368,20230215,18-21,저녁
21:00 ~ 23:59,14,14,23,61,2475200,84,20230215,21-24,저녁
합계,5376,5376,27226,57215,3886566042,84441,20230215,,
00:00 ~ 2:59,2,2,7,10,250000,17,20230216,0-3,심야
3:00 ~ 5:59,0,0,0,0,0,0,20230216,3-6,심야
6:00 ~ 8:59,0,0,0,0,0,0,20230216,6-9,심야
9:00 ~ 11:59,710,710,2210,6335,189671260,8545,20230216,9-12,주간
12:00 ~ 14:59,1297,1297,5809,11267,691337760,17076,20230216,12-15,주간
15:00 ~ 17:59,1349,1349,5395,13349,714147090,18744,20230216,15-18,주간
18:00 ~ 20:59,2001,2001,15587,28712,2382642998,44299,20230216,18-21,저녁
21:00 ~ 23:59,9,9,17,25,880280,42,20230216,21-24,저녁
합계,5368,5368,29025,59698,3978929388,88723,20230216,,
00:00 ~ 2:59,1,1,3,14,350000,17,20230217,0-3,심야
3:00 ~ 5:59,0,0,0,0,0,0,20230217,3-6,심야
6:00 ~ 8:59,0,0,0,0,0,0,20230217,6-9,심야
9:00 ~ 11:59,692,692,2128,5872,125757890,8000,20230217,9-12,주간
12:00 ~ 14:59,1309,1309,7114,12670,591414620,19784,20230217,12-15,주간
15:00 ~ 17:59,1380,1380,5996,15949,606506020,21945,20230217,15-18,주간
18:00 ~ 20:59,2001,2001,14281,22447,1426774320,36728,20230217,18-21,저녁
21:00 ~ 23:59,11,11,16,43,1631880,59,20230217,21-24,저녁
합계,5394,5394,29538,56995,2752434730,86533,20230217,,
00:00 ~ 2:59,2,2,5,-3,-75000,2,20230218,0-3,심야
3:00 ~ 5:59,0,0,0,0,0,0,20230218,3-6,심야
6:00 ~ 8:59,0,0,0,0,0,0,20230218,6-9,심야
9:00 ~ 11:59,702,702,1965,4063,107794570,6028,20230218,9-12,주간
12:00 ~ 14:59,1293,1293,6410,9316,468277410,15726,20230218,12-15,주간
15:00 ~ 17:59,1311,1311,5421,11048,385354200,16469,20230218,15-18,주간
18:00 ~ 20:59,1752,1752,10047,10912,752733784,20959,20230218,18-21,저녁
21:00 ~ 23:59,12,12,16,72,1962720,88,20230218,21-24,저녁
합계,5072,5072,23864,35408,1716047684,59272,20230218,,
00:00 ~ 2:59,1,1,0,2,50000,2,20230219,0-3,심야
3:00 ~ 5:59,0,0,0,0,0,0,20230219,3-6,심야
6:00 ~ 8:59,0,0,0,0,0,0,20230219,6-9,심야
9:00 ~ 11:59,633,633,1550,3494,101945150,5044,20230219,9-12,주간
12:00 ~ 14:59,1193,1193,6032,7212,372917600,13244,20230219,12-15,주간
15:00 ~ 17:59,1212,1212,3999,7443,279324550,11442,20230219,15-18,주간
18:00 ~ 20:59,1635,1635,8177,7905,582696920,16082,20230219,18-21,저녁
21:00 ~ 23:59,11,11,12,89,3333780,101,20230219,21-24,저녁
합계,4685,4685,19770,26145,1340268000,45915,20230219,,
00:00 ~ 2:59,1,1,2,-2,-50000,0,20230220,0-3,심야
3:00 ~ 5:59,0,0,0,0,0,0,20230220,3-6,심야
6:00 ~ 8:59,0,0,0,0,0,0,20230220,6-9,심야
9:00 ~ 11:59,636,636,1412,3285,95475130,4697,20230220,9-12,주간
12:00 ~ 14:59,1121,1121,4009,8418,374673240,12427,20230220,12-15,주간
15:00 ~ 17:59,1241,1241,4078,10163,517419120,14241,20230220,15-18,주간
18:00 ~ 20:59,1810,1810,10403,15515,650243640,25918,20230220,18-21,저녁
21:00 ~ 23:59,8,8,18,42,2103000,60,20230220,21-24,저녁
합계,4817,4817,19922,37421,1639864130,57343,20230220,,
00:00 ~ 2:59,0,0,0,0,0,0,20230221,0-3,심야
3:00 ~ 5:59,0,0,0,0,0,0,20230221,3-6,심야
6:00 ~ 8:59,0,0,0,0,0,0,20230221,6-9,심야
9:00 ~ 11:59,662,662,1804,4494,111133560,6298,20230221,9-12,주간
12:00 ~ 14:59,1220,1220,8260,15943,626710940,24203,20230221,12-15,주간
15:00 ~ 17:59,1309,1309,5033,12131,531791770,17164,20230221,15-18,주간
18:00 ~ 20:59,1957,1957,18868,36573,1367473770,55441,20230221,18-21,저녁
21:00 ~ 23:59,10,10,23,123,1246380,146,20230221,21-24,저녁
합계,5158,5158,33988,69264,2638356420,103252,20230221,,
00:00 ~ 2:59,1,1,0,11,275000,11,20230222,0-3,심야
3:00 ~ 5:59,0,0,0,0,0,0,20230222,3-6,심야
6:00 ~ 8:59,0,0,0,0,0,0,20230222,6-9,심야
9:00 ~ 11:59,670,670,2737,5923,117193960,8660,20230222,9-12,주간
12:00 ~ 14:59,1206,1206,6685,13674,785513850,20359,20230222,12-15,주간
15:00 ~ 17:59,1356,1356,4832,11516,353119990,16348,20230222,15-18,주간
18:00 ~ 20:59,1975,1975,16618,32432,2338478742,49050,20230222,18-21,저녁
21:00 ~ 23:59,13,13,31,86,1787500,117,20230222,21-24,저녁
합계,5221,5221,30903,63642,3596369042,94545,20230222,,
00:00 ~ 2:59,1,1,0,7,175000,7,20230223,0-3,심야
3:00 ~ 5:59,0,0,0,0,0,0,20230223,3-6,심야
6:00 ~ 8:59,0,0,0,0,0,0,20230223,6-9,심야
9:00 ~ 11:59,663,663,1598,4388,103835110,5986,20230223,9-12,주간
12:00 ~ 14:59,1234,1234,8101,14541,1024994270,22642,20230223,12-15,주간
15:00 ~ 17:59,1392,1392,5378,11854,467454470,17232,20230223,15-18,주간
18:00 ~ 20:59,1974,1974,21256,31027,2466849610,52283,20230223,18-21,저녁
21:00 ~ 23:59,16,16,29,45,1893560,74,20230223,21-24,저녁
합계,5280,5280,36362,61862,4065202020,98224,20230223,,
00:00 ~ 2:59,3,3,6,3,75000,9,20230224,0-3,심야
3:00 ~ 5:59,0,0,0,0,0,0,20230224,3-6,심야
6:00 ~ 8:59,0,0,0,0,0,0,20230224,6-9,심야
9:00 ~ 11:59,652,652,1918,6171,131394030,8089,20230224,9-12,주간
12:00 ~ 14:59,1242,1242,7738,13035,605047150,20773,20230224,12-15,주간
15:00 ~ 17:59,1398,1398,5264,15050,418092262,20314,20230224,15-18,주간
18:00 ~ 20:59,1905,1905,16352,18781,1006124790,35133,20230224,18-21,저녁
21:00 ~ 23:59,14,14,21,38,1273900,59,20230224,21-24,저녁
합계,5214,5214,31299,53078,2162007132,84377,20230224,,
00:00 ~ 2:59,1,1,9,5,125000,14,20230225,0-3,심야
3:00 ~ 5:59,0,0,0,0,0,0,20230225,3-6,심야
6:00 ~ 8:59,0,0,0,0,0,0,20230225,6-9,심야
9:00 ~ 11:59,628,628,2533,3738,100771120,6271,20230225,9-12,주간
12:00 ~ 14:59,1228,1228,7503,7984,446447790,15487,20230225,12-15,주간
15:00 ~ 17:59,1356,1356,5916,9500,294739510,15416,20230225,15-18,주간
18:00 ~ 20:59,1682,1682,13651,8292,599172442,21943,20230225,18-21,저녁
21:00 ~ 23:59,14,14,7,77,1596100,84,20230225,21-24,저녁
합계,4909,4909,29619,29596,1442851962,59215,20230225,,
00:00 ~ 2:59,0,0,0,0,0,0,20230226,0-3,심야
3:00 ~ 5:59,0,0,0,0,0,0,20230226,3-6,심야
6:00 ~ 8:59,0,0,0,0,0,0,20230226,6-9,심야
9:00 ~ 11:59,612,612,1578,3139,92530130,4717,20230226,9-12,주간
12:00 ~ 14:59,1112,1112,6538,6149,381241830,12687,20230226,12-15,주간
15:00 ~ 17:59,1232,1232,4440,7908,278198540,12348,20230226,15-18,주간
18:00 ~ 20:59,1620,1620,8705,7797,489766360,16502,20230226,18-21,저녁
21:00 ~ 23:59,7,7,4,61,1507280,65,20230226,21-24,저녁
합계,4583,4583,21265,25054,1243244140,46319,20230226,,
00:00 ~ 2:59,0,0,0,0,0,0,20230227,0-3,심야
3:00 ~ 5:59,0,0,0,0,0,0,20230227,3-6,심야
6:00 ~ 8:59,0,0,0,0,0,0,20230227,6-9,심야
9:00 ~ 11:59,564,564,1493,3542,89548410,5035,20230227,9-12,주간
12:00 ~ 14:59,1063,1063,6812,17428,1526028975,24240,20230227,12-15,주간
15:00 ~ 17:59,1216,1216,4252,9286,407085455,13538,20230227,15-18,주간
18:00 ~ 20:59,1798,1798,11815,14561,885930840,26376,20230227,18-21,저녁
21:00 ~ 23:59,9,9,113,-15,360280,98,20230227,21-24,저녁
합계,4650,4650,24485,44802,2908953960,69287,20230227,,
00:00 ~ 2:59,2,2,0,48,0,48,20230228,0-3,심야
3:00 ~ 5:59,6,6,2,132,0,134,20230228,3-6,심야
6:00 ~ 8:59,0,0,0,0,0,0,20230228,6-9,심야
9:00 ~ 11:59,577,577,2070,4301,104127750,6371,20230228,9-12,주간
12:00 ~ 14:59,1129,1129,10761,30070,1139444060,40831,20230228,12-15,주간
15:00 ~ 17:59,1293,1293,4288,12870,537632450,17158,20230228,15-18,주간
18:00 ~ 20:59,1897,1897,17916,35260,1620870010,53176,20230228,18-21,저녁
21:00 ~ 23:59,15,15,16,20,661300,36,20230228,21-24,저녁
합계,4919,4919,35053,82701,3402735570,117754,20230228,,
00:00 ~ 2:59,1,1,0,4,0,4,20230301,0-3,심야
3:00 ~ 5:59,2,2,0,8,0,8,20230301,3-6,심야
6:00 ~ 8:59,0,0,0,0,0,0,20230301,6-9,심야
9:00 ~ 11:59,601,601,1840,3436,106215540,5276,20230301,9-12,주간
12:00 ~ 14:59,1174,1174,6967,8484,634749190,15451,20230301,12-15,주간
15:00 ~ 17:59,1302,1302,3816,7848,283220450,11664,20230301,15-18,주간
18:00 ~ 20:59,1890,1890,11281,10264,721319210,21545,20230301,18-21,저녁
21:00 ~ 23:59,9,9,18,6,22260,24,20230301,21-24,저녁
합계,4979,4979,23922,30050,1745526650,53972,20230301,,
00:00 ~ 2:59,2,2,0,92,0,92,20230302,0-3,심야
3:00 ~ 5:59,6,6,0,248,0,248,20230302,3-6,심야
6:00 ~ 8:59,0,0,0,0,0,0,20230302,6-9,심야
9:00 ~ 11:59,578,578,1627,9247,72950070,10874,20230302,9-12,주간
12:00 ~ 14:59,1086,1086,6505,7920,490227910,14425,20230302,12-15,주간
15:00 ~ 17:59,1304,1304,8176,13808,1033700190,21984,20230302,15-18,주간
18:00 ~ 20:59,2008,2008,15079,20989,1268282930,36068,20230302,18-21,저녁
21:00 ~ 23:59,9,9,11,21,436200,32,20230302,21-24,저녁
합계,4993,4993,31398,52325,2865597300,83723,20230302,,
00:00 ~ 2:59,2,2,0,69,0,69,20230303,0-3,심야
3:00 ~ 5:59,6,6,0,159,0,159,20230303,3-6,심야
6:00 ~ 8:59,0,0,0,0,0,0,20230303,6-9,심야
9:00 ~ 11:59,610,610,1199,5900,104093790,7099,20230303,9-12,주간
12:00 ~ 14:59,1173,1173,7314,13171,363774710,20485,20230303,12-15,주간
15:00 ~ 17:59,1307,1307,5477,11952,386997410,17429,20230303,15-18,주간
18:00 ~ 20:59,1988,1988,14571,26712,1565556010,41283,20230303,18-21,저녁
21:00 ~ 23:59,9,9,6,36,697000,42,20230303,21-24,저녁
합계,5095,5095,28567,57999,2421118920,86566,20230303,,
00:00 ~ 2:59,2,2,0,26,0,26,20230304,0-3,심야
3:00 ~ 5:59,6,6,0,78,0,78,20230304,3-6,심야
6:00 ~ 8:59,0,0,0,0,0,0,20230304,6-9,심야
9:00 ~ 11:59,592,592,1342,3581,99503760,4923,20230304,9-12,주간
12:00 ~ 14:59,1188,1188,5022,7901,466110370,12923,20230304,12-15,주간
15:00 ~ 17:59,1305,1305,4784,9876,306868300,14660,20230304,15-18,주간
18:00 ~ 20:59,1786,1786,8288,8989,663597610,17277,20230304,18-21,저녁
21:00 ~ 23:59,13,13,16,25,452760,41,20230304,21-24,저녁
합계,4892,4892,19452,30476,1536532800,49928,20230304,,
00:00 ~ 2:59,2,2,0,12,0,12,20230305,0-3,심야
3:00 ~ 5:59,6,6,0,41,0,41,20230305,3-6,심야
6:00 ~ 8:59,0,0,0,0,0,0,20230305,6-9,심야
9:00 ~ 11:59,574,574,1155,2990,88730300,4145,20230305,9-12,주간
12:00 ~ 14:59,1125,1125,5707,5603,335379690,11310,20230305,12-15,주간
15:00 ~ 17:59,1205,1205,3967,7338,250117680,11305,20230305,15-18,주간
18:00 ~ 20:59,1735,1735,7665,6986,527310510,14651,20230305,18-21,저녁
21:00 ~ 23:59,9,9,4,13,165280,17,20230305,21-24,저녁
합계,4656,4656,18498,22983,1201703460,41481,20230305,,
00:00 ~ 2:59,2,2,0,36,0,36,20230306,0-3,심야
3:00 ~ 5:59,6,6,0,92,0,92,20230306,3-6,심야
6:00 ~ 8:59,0,0,0,0,0,0,20230306,6-9,심야
9:00 ~ 11:59,583,583,1349,4199,132206150,5548,20230306,9-12,주간
12:00 ~ 14:59,1072,1072,5865,13204,663560590,19069,20230306,12-15,주간
15:00 ~ 17:59,1248,1248,5080,8757,391171470,13837,20230306,15-18,주간
18:00 ~ 20:59,1978,1978,12743,23045,1134720330,35788,20230306,18-21,저녁
21:00 ~ 23:59,12,12,9,22,448000,31,20230306,21-24,저녁
합계,4901,4901,25046,49355,2322106540,74401,20230306,,
00:00 ~ 2:59,2,2,0,28,0,28,20230307,0-3,심야
3:00 ~ 5:59,6,6,0,76,0,76,20230307,3-6,심야
6:00 ~ 8:59,0,0,0,0,0,0,20230307,6-9,심야
9:00 ~ 11:59,625,625,1550,10858,127420810,12408,20230307,9-12,주간
12:00 ~ 14:59,1147,1147,7711,12780,950654340,20491,20230307,12-15,주간
15:00 ~ 17:59,1295,1295,5028,12375,725035506,17403,20230307,15-18,주간
18:00 ~ 20:59,2010,2010,16485,27900,1933042164,44385,20230307,18-21,저녁
21:00 ~ 23:59,11,11,8,23,499560,31,20230307,21-24,저녁
합계,5096,5096,30782,64040,3736652380,94822,20230307,,
00:00 ~ 2:59,2,2,0,26,0,26,20230308,0-3,심야
3:00 ~ 5:59,6,6,0,93,0,93,20230308,3-6,심야
6:00 ~ 8:59,0,0,0,0,0,0,20230308,6-9,심야
9:00 ~ 11:59,612,612,1261,3901,98947960,5162,20230308,9-12,주간
12:00 ~ 14:59,1143,1143,5393,8937,649222370,14330,20230308,12-15,주간
15:00 ~ 17:59,1288,1288,3974,9162,375947476,13136,20230308,15-18,주간
18:00 ~ 20:59,2059,2059,13199,22209,1417402257,35408,20230308,18-21,저녁
21:00 ~ 23:59,11,11,10,19,536660,29,20230308,21-24,저녁
합계,5121,5121,23837,44347,2542056723,68184,20230308,,
00:00 ~ 2:59,2,2,0,16,0,16,20230309,0-3,심야
3:00 ~ 5:59,5,5,0,48,0,48,20230309,3-6,심야
6:00 ~ 8:59,0,0,0,0,0,0,20230309,6-9,심야
9:00 ~ 11:59,624,624,1824,4691,136037050,6515,20230309,9-12,주간
12:00 ~ 14:59,1212,1212,7884,18242,1246701300,26126,20230309,12-15,주간
15:00 ~ 17:59,1304,1304,4254,14258,502537500,18512,20230309,15-18,주간
18:00 ~ 20:59,2101,2101,14456,35029,1763099952,49485,20230309,18-21,저녁
21:00 ~ 23:59,15,15,35,7,237380,42,20230309,21-24,저녁
합계,5263,5263,28453,72291,3648613182,100744,20230309,,
00:00 ~ 2:59,2,2,0,21,0,21,20230310,0-3,심야
3:00 ~ 5:59,5,5,0,48,0,48,20230310,3-6,심야
6:00 ~ 8:59,0,0,0,0,0,0,20230310,6-9,심야
9:00 ~ 11:59,636,636,2800,7441,181166930,10241,20230310,9-12,주간
12:00 ~ 14:59,1236,1236,8200,18401,850412660,26601,20230310,12-15,주간
15:00 ~ 17:59,1332,1332,4373,15003,428099400,19376,20230310,15-18,주간
18:00 ~ 20:59,2094,2094,12815,23441,1138319810,36256,20230310,18-21,저녁
21:00 ~ 23:59,8,8,16,34,597500,50,20230310,21-24,저녁
합계,5313,5313,28204,64389,2598596300,92593,20230310,,
00:00 ~ 2:59,1,1,0,2,0,2,20230311,0-3,심야
3:00 ~ 5:59,4,4,0,19,0,19,20230311,3-6,심야
6:00 ~ 8:59,0,0,0,0,0,0,20230311,6-9,심야
9:00 ~ 11:59,602,602,1343,3711,110146810,5054,20230311,9-12,주간
12:00 ~ 14:59,1222,1222,4547,9914,515521700,14461,20230311,12-15,주간
15:00 ~ 17:59,1260,1260,4086,8569,280324890,12655,20230311,15-18,주간
18:00 ~ 20:59,1834,1834,8322,10962,727694100,19284,20230311,18-21,저녁
21:00 ~ 23:59,9,9,15,22,257610,37,20230311,21-24,저녁
합계,4932,4932,18313,33199,1633945110,51512,20230311,,
00:00 ~ 2:59,2,2,0,8,0,8,20230312,0-3,심야
3:00 ~ 5:59,6,6,0,21,30000,21,20230312,3-6,심야
6:00 ~ 8:59,0,0,0,0,0,0,20230312,6-9,심야
9:00 ~ 11:59,577,577,1269,3066,93860420,4335,20230312,9-12,주간
12:00 ~ 14:59,1130,1130,4638,7436,418714090,12074,20230312,12-15,주간
15:00 ~ 17:59,1214,1214,2888,7655,256586290,10543,20230312,15-18,주간
18:00 ~ 20:59,1767,1767,6375,8508,515803440,14883,20230312,18-21,저녁
21:00 ~ 23:59,12,12,9,19,337560,28,20230312,21-24,저녁
합계,4708,4708,15179,26713,1285331800,41892,20230312,,
00:00 ~ 2:59,2,2,0,16,0,16,20230313,0-3,심야
3:00 ~ 5:59,5,5,0,41,0,41,20230313,3-6,심야
6:00 ~ 8:59,0,0,0,0,0,0,20230313,6-9,심야
9:00 ~ 11:59,569,569,1067,3752,91315410,4819,20230313,9-12,주간
12:00 ~ 14:59,1063,1063,4745,6360,363381860,11105,20230313,12-15,주간
15:00 ~ 17:59,1227,1227,4261,8116,478413980,12377,20230313,15-18,주간
18:00 ~ 20:59,2001,2001,10964,15224,829246210,26188,20230313,18-21,저녁
21:00 ~ 23:59,13,13,44,21,4940,65,20230313,21-24,저녁
합계,4880,4880,21081,33530,1762362400,54611,20230313,,
00:00 ~ 2:59,2,2,0,5,0,5,20230314,0-3,심야
3:00 ~ 5:59,6,6,0,17,0,17,20230314,3-6,심야
6:00 ~ 8:59,0,0,0,0,0,0,20230314,6-9,심야
9:00 ~ 11:59,639,639,1512,3965,115443510,5477,20230314,9-12,주간
12:00 ~ 14:59,1203,1203,8724,14485,868073870,23209,20230314,12-15,주간
15:00 ~ 17:59,1288,1288,4684,9201,369297880,13885,20230314,15-18,주간
18:00 ~ 20:59,2139,2139,14501,29527,959315390,44028,20230314,18-21,저녁
21:00 ~ 23:59,13,13,21,25,925080,46,20230314,21-24,저녁
합계,5290,5290,29442,57225,2313055730,86667,20230314,,
00:00 ~ 2:59,2,2,0,8,0,8,20230315,0-3,심야
3:00 ~ 5:59,4,4,0,22,0,22,20230315,3-6,심야
6:00 ~ 8:59,0,0,0,0,0,0,20230315,6-9,심야
9:00 ~ 11:59,647,647,1599,4388,102843910,5987,20230315,9-12,주간
12:00 ~ 14:59,1235,1235,8197,30152,1841821260,38349,20230315,12-15,주간
15:00 ~ 17:59,1281,1281,5296,11113,512518010,16409,20230315,15-18,주간
18:00 ~ 20:59,2218,2218,15329,55983,3276183260,71312,20230315,18-21,저녁
21:00 ~ 23:59,10,10,25,174,7402720,199,20230315,21-24,저녁
합계,5397,5397,30446,101840,5740769160,132286,20230315,,
00:00 ~ 2:59,1,1,0,10,0,10,20230316,0-3,심야
3:00 ~ 5:59,4,4,0,37,0,37,20230316,3-6,심야
6:00 ~ 8:59,0,0,0,0,0,0,20230316,6-9,심야
9:00 ~ 11:59,654,654,1619,4105,96722160,5724,20230316,9-12,주간
12:00 ~ 14:59,1246,1246,11399,26627,1932640090,38026,20230316,12-15,주간
15:00 ~ 17:59,1342,1342,5010,13414,433655590,18424,20230316,15-18,주간
18:00 ~ 20:59,2231,2231,21782,48258,3242732990,70040,20230316,18-21,저녁
21:00 ~ 23:59,10,10,24,205,8668500,229,20230316,21-24,저녁
합계,5488,5488,39834,92656,5714419330,132490,20230316,,
00:00 ~ 2:59,1,1,0,5,0,5,20230317,0-3,심야
3:00 ~ 5:59,3,3,0,24,0,24,20230317,3-6,심야
6:00 ~ 8:59,0,0,0,0,0,0,20230317,6-9,심야
9:00 ~ 11:59,700,700,1968,7027,136196800,8995,20230317,9-12,주간
12:00 ~ 14:59,1374,1374,11385,22192,1921697940,33577,20230317,12-15,주간
15:00 ~ 17:59,1347,1347,4980,11970,361462210,16950,20230317,15-18,주간
18:00 ~ 20:59,2153,2153,20939,26861,1948546150,47800,20230317,18-21,저녁
21:00 ~ 23:59,12,12,27,94,3910300,121,20230317,21-24,저녁
합계,5590,5590,39299,68173,4371813400,107472,20230317,,
00:00 ~ 2:59,0,0,0,0,0,0,20230318,0-3,심야
3:00 ~ 5:59,0,0,0,0,0,0,20230318,3-6,심야
6:00 ~ 8:59,0,0,0,0,0,0,20230318,6-9,심야
9:00 ~ 11:59,629,629,1242,3593,111667000,4835,20230318,9-12,주간
12:00 ~ 14:59,1363,1363,6824,13589,1020175360,20413,20230318,12-15,주간
15:00 ~ 17:59,1372,1372,4154,9118,274656990,13272,20230318,15-18,주간
18:00 ~ 20:59,1928,1928,12680,14292,1119940240,26972,20230318,18-21,저녁
21:00 ~ 23:59,14,14,20,100,3289580,120,20230318,21-24,저녁
합계,5306,5306,24920,40692,2529729170,65612,20230318,,
00:00 ~ 2:59,0,0,0,0,0,0,20230319,0-3,심야
3:00 ~ 5:59,5,5,0,16,0,16,20230319,3-6,심야
6:00 ~ 8:59,0,0,0,0,0,0,20230319,6-9,심야
9:00 ~ 11:59,578,578,1161,3042,99740230,4203,20230319,9-12,주간
12:00 ~ 14:59,1301,1301,6340,10210,822947600,16550,20230319,12-15,주간
15:00 ~ 17:59,1234,1234,3734,6310,216185010,10044,20230319,15-18,주간
18:00 ~ 20:59,1910,1910,12046,10427,802596960,22473,20230319,18-21,저녁
21:00 ~ 23:59,7,7,15,113,4822100,128,20230319,21-24,저녁
합계,5035,5035,23296,30118,1946291900,53414,20230319,,
00:00 ~ 2:59,0,0,0,0,0,0,20230320,0-3,심야
3:00 ~ 5:59,0,0,0,0,0,0,20230320,3-6,심야
6:00 ~ 8:59,0,0,0,0,0,0,20230320,6-9,심야
9:00 ~ 11:59,595,595,1153,3271,103737750,4424,20230320,9-12,주간
12:00 ~ 14:59,1186,1186,8804,12880,1061603860,21684,20230320,12-15,주간
15:00 ~ 17:59,1253,1253,3645,7784,451902340,11429,20230320,15-18,주간
18:00 ~ 20:59,2098,2098,14080,18679,1255881660,32759,20230320,18-21,저녁
21:00 ~ 23:59,17,17,33,174,7895700,207,20230320,21-24,저녁
합계,5149,5149,27715,42788,2881021310,70503,20230320,,
00:00 ~ 2:59,0,0,0,0,0,0,20230321,0-3,심야
3:00 ~ 5:59,1,1,0,19,0,19,20230321,3-6,심야
6:00 ~ 8:59,0,0,0,0,0,0,20230321,6-9,심야
9:00 ~ 11:59,648,648,1600,5015,153090840,6615,20230321,9-12,주간
12:00 ~ 14:59,1282,1282,13305,12018,972524910,25323,20230321,12-15,주간
15:00 ~ 17:59,1312,1312,6120,13330,898936505,19450,20230321,15-18,주간
18:00 ~ 20:59,2181,2181,24535,29670,1937082195,54205,20230321,18-21,저녁
21:00 ~ 23:59,11,11,21,67,3381300,88,20230321,21-24,저녁
합계,5435,5435,45581,60119,3965015750,105700,20230321,,
00:00 ~ 2:59,0,0,0,0,0,0,20230322,0-3,심야
3:00 ~ 5:59,6,6,0,12,40000,12,20230322,3-6,심야
6:00 ~ 8:59,0,0,0,0,0,0,20230322,6-9,심야
9:00 ~ 11:59,665,665,1769,4716,115690000,6485,20230322,9-12,주간
12:00 ~ 14:59,1266,1266,7829,15885,1398244706,23714,20230322,12-15,주간
15:00 ~ 17:59,1363,1363,4981,11373,389352300,16354,20230322,15-18,주간
18:00 ~ 20:59,2194,2194,15095,22581,1321980720,37676,20230322,18-21,저녁
21:00 ~ 23:59,14,14,31,40,2066100,71,20230322,21-24,저녁
합계,5508,5508,29705,54607,3227373826,84312,20230322,,
00:00 ~ 2:59,0,0,0,0,0,0,20230323,0-3,심야
3:00 ~ 5:59,5,5,2,18,-30000,20,20230323,3-6,심야
6:00 ~ 8:59,0,0,0,0,0,0,20230323,6-9,심야
9:00 ~ 11:59,648,648,2007,3823,99603570,5830,20230323,9-12,주간
12:00 ~ 14:59,1329,1329,8411,13098,1077407156,21509,20230323,12-15,주간
15:00 ~ 17:59,1286,1286,5843,14684,855906230,20527,20230323,15-18,주간
18:00 ~ 20:59,2178,2178,18881,32324,2432468716,51205,20230323,18-21,저녁
21:00 ~ 23:59,14,14,64,26,1992300,90,20230323,21-24,저녁
합계,5460,5460,35208,63973,4467347972,99181,20230323,,
00:00 ~ 2:59,0,0,0,0,0,0,20230324,0-3,심야
3:00 ~ 5:59,4,4,0,8,100000,8,20230324,3-6,심야
6:00 ~ 8:59,0,0,0,0,0,0,20230324,6-9,심야
9:00 ~ 11:59,695,695,1564,5320,109810640,6884,20230324,9-12,주간
12:00 ~ 14:59,1335,1335,8106,13931,871659416,22037,20230324,12-15,주간
15:00 ~ 17:59,1376,1376,5145,13517,805054537,18662,20230324,15-18,주간
18:00 ~ 20:59,2220,2220,16007,26109,1884153737,42116,20230324,18-21,저녁
21:00 ~ 23:59,14,14,55,42,1930000,97,20230324,21-24,저녁
합계,5644,5644,30877,58927,3672708330,89804,20230324,,
00:00 ~ 2:59,0,0,0,0,0,0,20230325,0-3,심야
3:00 ~ 5:59,1,1,1,1,20000,2,20230325,3-6,심야
6:00 ~ 8:59,0,0,0,0,0,0,20230325,6-9,심야
9:00 ~ 11:59,657,657,1659,4134,108385540,5793,20230325,9-12,주간
12:00 ~ 14:59,1366,1366,6337,12687,766510130,19024,20230325,12-15,주간
15:00 ~ 17:59,1303,1303,3941,10677,291464060,14618,20230325,15-18,주간
18:00 ~ 20:59,1925,1925,10845,13097,869365172,23942,20230325,18-21,저녁
21:00 ~ 23:59,13,13,14,98,3697000,112,20230325,21-24,저녁
합계,5265,5265,22797,40694,2039441902,63491,20230325,,
00:00 ~ 2:59,0,0,0,0,0,0,20230326,0-3,심야
3:00 ~ 5:59,4,4,0,8,80000,8,20230326,3-6,심야
6:00 ~ 8:59,0,0,0,0,0,0,20230326,6-9,심야
9:00 ~ 11:59,635,635,1187,2945,97840940,4132,20230326,9-12,주간
12:00 ~ 14:59,1245,1245,5473,11071,779631790,16544,20230326,12-15,주간
15:00 ~ 17:59,1187,1187,3536,6852,295428834,10388,20230326,15-18,주간
18:00 ~ 20:59,1829,1829,8351,13926,993350318,22277,20230326,18-21,저녁
21:00 ~ 23:59,13,13,20,55,1273300,75,20230326,21-24,저녁
합계,4913,4913,18567,34857,2167605182,53424,20230326,,
00:00 ~ 2:59,0,0,0,0,0,0,20230327,0-3,심야
3:00 ~ 5:59,1,1,0,2,0,2,20230327,3-6,심야
6:00 ~ 8:59,0,0,0,0,0,0,20230327,6-9,심야
9:00 ~ 11:59,611,611,1062,3429,92154850,4491,20230327,9-12,주간
12:00 ~ 14:59,1209,1209,6067,8328,684430600,14395,20230327,12-15,주간
15:00 ~ 17:59,1198,1198,4184,11797,700343860,15981,20230327,15-18,주간
18:00 ~ 20:59,2028,2028,13062,20366,1461025500,33428,20230327,18-21,저녁
21:00 ~ 23:59,8,8,28,35,2352100,63,20230327,21-24,저녁
합계,5055,5055,24403,43957,2940306910,68360,20230327,,
00:00 ~ 2:59,0,0,0,0,0,0,20230328,0-3,심야
3:00 ~ 5:59,10,10,2,200,80000,202,20230328,3-6,심야
6:00 ~ 8:59,0,0,0,0,0,0,20230328,6-9,심야
9:00 ~ 11:59,654,654,1645,4273,102583670,5918,20230328,9-12,주간
12:00 ~ 14:59,1254,1254,8458,13678,961485150,22136,20230328,12-15,주간
15:00 ~ 17:59,1304,1304,4701,11753,540686351,16454,20230328,15-18,주간
18:00 ~ 20:59,2083,2083,17072,32907,1993169660,49979,20230328,18-21,저녁
21:00 ~ 23:59,14,14,38,38,1500840,76,20230328,21-24,저녁
합계,5319,5319,31916,62849,3599505671,94765,20230328,,
00:00 ~ 2:59,0,0,0,0,0,0,20230329,0-3,심야
3:00 ~ 5:59,8,8,0,369,40000,369,20230329,3-6,심야
6:00 ~ 8:59,0,0,0,0,0,0,20230329,6-9,심야
9:00 ~ 11:59,638,638,1813,3489,91779170,5302,20230329,9-12,주간
12:00 ~ 14:59,1261,1261,8454,10572,687282180,19026,20230329,12-15,주간
15:00 ~ 17:59,1274,1274,5663,11643,712097940,17306,20230329,15-18,주간
18:00 ~ 20:59,2114,2114,18608,25372,1613038060,43980,20230329,18-21,저녁
21:00 ~ 23:59,17,17,31,30,1006240,61,20230329,21-24,저녁
합계,5312,5312,34569,51475,3105243590,86044,20230329,,
00:00 ~ 2:59,0,0,0,0,0,0,20230330,0-3,심야
3:00 ~ 5:59,9,9,0,557,40000,557,20230330,3-6,심야
6:00 ~ 8:59,0,0,0,0,0,0,20230330,6-9,심야
9:00 ~ 11:59,636,636,1408,5527,125878340,6935,20230330,9-12,주간
12:00 ~ 14:59,1333,1333,7859,15473,1174062000,23332,20230330,12-15,주간
15:00 ~ 17:59,1337,1337,5744,10515,584235900,16259,20230330,15-18,주간
18:00 ~ 20:59,2174,2174,18321,31082,2194064650,49403,20230330,18-21,저녁
21:00 ~ 23:59,15,15,95,57,4323000,152,20230330,21-24,저녁
합계,5504,5504,33427,63211,4082603890,96638,20230330,,
00:00 ~ 2:59,0,0,0,0,0,0,20230331,0-3,심야
3:00 ~ 5:59,9,9,1,122,80000,123,20230331,3-6,심야
6:00 ~ 8:59,1,1,2,17,510000,19,20230331,6-9,심야
9:00 ~ 11:59,679,679,2021,7123,100809760,9144,20230331,9-12,주간
12:00 ~ 14:59,1403,1403,6543,12789,771974890,19332,20230331,12-15,주간
15:00 ~ 17:59,1350,1350,5614,12847,341177461,18461,20230331,15-18,주간
18:00 ~ 20:59,2119,2119,15181,23475,1221939060,38656,20230331,18-21,저녁
21:00 ~ 23:59,12,12,41,54,2197300,95,20230331,21-24,저녁
합계,5573,5573,29403,56427,2438688471,85830,20230331,,
00:00 ~ 2:59,0,0,0,0,0,0,20230401,0-3,심야
3:00 ~ 5:59,9,9,0,192,60000,192,20230401,3-6,심야
6:00 ~ 8:59,1,1,2,2,60000,4,20230401,6-9,심야
9:00 ~ 11:59,664,664,1323,3710,108916160,5033,20230401,9-12,주간
12:00 ~ 14:59,1403,1403,6509,11848,814652980,18357,20230401,12-15,주간
15:00 ~ 17:59,1374,1374,4019,8529,316913290,12548,20230401,15-18,주간
18:00 ~ 20:59,1997,1997,11569,18402,1055133341,29971,20230401,18-21,저녁
21:00 ~ 23:59,14,14,38,59,1872000,97,20230401,21-24,저녁
합계,5462,5462,23460,42742,2297607771,66202,20230401,,
00:00 ~ 2:59,0,0,0,0,0,0,20230402,0-3,심야
3:00 ~ 5:59,8,8,21,144,40000,165,20230402,3-6,심야
6:00 ~ 8:59,1,1,0,1,30000,1,20230402,6-9,심야
9:00 ~ 11:59,584,584,1063,2822,98512460,3885,20230402,9-12,주간
12:00 ~ 14:59,1288,1288,6513,8396,662879770,14909,20230402,12-15,주간
15:00 ~ 17:59,1215,1215,3548,7157,239962201,10705,20230402,15-18,주간
18:00 ~ 20:59,1881,1881,8575,9905,752311052,18480,20230402,18-21,저녁
21:00 ~ 23:59,13,13,23,81,1925900,104,20230402,21-24,저녁
합계,4990,4990,19743,28506,1755661383,48249,20230402,,
00:00 ~ 2:59,0,0,0,0,0,0,20230403,0-3,심야
3:00 ~ 5:59,5,5,0,25,0,25,20230403,3-6,심야
6:00 ~ 8:59,0,0,0,0,0,0,20230403,6-9,심야
9:00 ~ 11:59,633,633,1309,3674,88783840,4983,20230403,9-12,주간
12:00 ~ 14:59,1287,1287,6412,10553,631674572,16965,20230403,12-15,주간
15:00 ~ 17:59,1312,1312,4277,8582,373989641,12859,20230403,15-18,주간
18:00 ~ 20:59,2064,2064,12059,23598,1276077368,35657,20230403,18-21,저녁
21:00 ~ 23:59,12,12,125,181,4631000,306,20230403,21-24,저녁
합계,5313,5313,24182,46613,2375156421,70795,20230403,,
00:00 ~ 2:59,0,0,0,0,0,0,20230404,0-3,심야
3:00 ~ 5:59,4,4,0,41,24000,41,20230404,3-6,심야
6:00 ~ 8:59,1,1,2,-1,-30000,1,20230404,6-9,심야
9:00 ~ 11:59,616,616,1323,3566,94601480,4889,20230404,9-12,주간
12:00 ~ 14:59,1296,1296,8155,15498,840973550,23653,20230404,12-15,주간
15:00 ~ 17:59,1301,1301,5128,7633,260340090,12761,20230404,15-18,주간
18:00 ~ 20:59,2171,2171,20349,44236,3149280390,64585,20230404,18-21,저녁
21:00 ~ 23:59,12,12,79,150,2295380,229,20230404,21-24,저녁
합계,5401,5401,35036,71123,4347484890,106159,20230404,,
00:00 ~ 2:59,1,1,6,42,1680000,48,20230405,0-3,심야
3:00 ~ 5:59,4,4,0,33,20000,33,20230405,3-6,심야
6:00 ~ 8:59,0,0,0,0,0,0,20230405,6-9,심야
9:00 ~ 11:59,626,626,1839,6013,126780240,7852,20230405,9-12,주간
12:00 ~ 14:59,1320,1320,8128,15943,1291730390,24071,20230405,12-15,주간
15:00 ~ 17:59,1378,1378,5062,12128,632797703,17190,20230405,15-18,주간
18:00 ~ 20:59,2224,2224,18235,37864,3374448600,56099,20230405,18-21,저녁
21:00 ~ 23:59,11,11,53,147,1858000,200,20230405,21-24,저녁
합계,5564,5564,33323,72170,5429314933,105493,20230405,,
00:00 ~ 2:59,1,1,4,1,40000,5,20230406,0-3,심야
3:00 ~ 5:59,6,6,1,17,186000,18,20230406,3-6,심야
6:00 ~ 8:59,0,0,0,0,0,0,20230406,6-9,심야
9:00 ~ 11:59,655,655,1475,6870,107076680,8345,20230406,9-12,주간
12:00 ~ 14:59,1396,1396,6706,16322,1130428598,23028,20230406,12-15,주간
15:00 ~ 17:59,1431,1431,5834,19697,911190130,25531,20230406,15-18,주간
18:00 ~ 20:59,2227,2227,24359,46528,4097600130,70887,20230406,18-21,저녁
21:00 ~ 23:59,11,11,132,166,2140200,298,20230406,21-24,저녁
합계,5727,5727,38511,89601,6248661738,128112,20230406,,
00:00 ~ 2:59,1,1,1,-1,-40000,0,20230407,0-3,심야
3:00 ~ 5:59,1,1,0,2,80000,2,20230407,3-6,심야
6:00 ~ 8:59,0,0,0,0,0,0,20230407,6-9,심야
9:00 ~ 11:59,681,681,1836,5050,92969760,6886,20230407,9-12,주간
12:00 ~ 14:59,1449,1449,7436,13762,874309250,21198,20230407,12-15,주간
15:00 ~ 17:59,1417,1417,6042,16613,728551070,22655,20230407,15-18,주간
18:00 ~ 20:59,2159,2159,21453,24991,1682721250,46444,20230407,18-21,저녁
21:00 ~ 23:59,13,13,51,117,3560800,168,20230407,21-24,저녁
합계,5721,5721,36819,60534,3382152130,97353,20230407,,
00:00 ~ 2:59,0,0,0,0,0,0,20230408,0-3,심야
3:00 ~ 5:59,5,5,0,57,60000,57,20230408,3-6,심야
6:00 ~ 8:59,1,1,0,2,60000,2,20230408,6-9,심야
9:00 ~ 11:59,629,629,1369,3332,102799940,4701,20230408,9-12,주간
12:00 ~ 14:59,1400,1400,6509,12013,751410272,18522,20230408,12-15,주간
15:00 ~ 17:59,1422,1422,4832,11352,313936780,16184,20230408,15-18,주간
18:00 ~ 20:59,1965,1965,12679,13765,965454800,26444,20230408,18-21,저녁
21:00 ~ 23:59,9,9,19,65,1759000,84,20230408,21-24,저녁
합계,5431,5431,25408,40586,2135480792,65994,20230408,,
00:00 ~ 2:59,1,1,3,-3,-120000,0,20230409,0-3,심야
3:00 ~ 5:59,4,4,3,11,40000,14,20230409,3-6,심야
6:00 ~ 8:59,1,1,3,-3,-90000,0,20230409,6-9,심야
9:00 ~ 11:59,575,575,1660,2718,94169270,4378,20230409,9-12,주간
12:00 ~ 14:59,1306,1306,6630,8574,588379740,15204,20230409,12-15,주간
15:00 ~ 17:59,1301,1301,3836,7505,285327510,11341,20230409,15-18,주간
18:00 ~ 20:59,1917,1917,11537,8764,680937210,20301,20230409,18-21,저녁
21:00 ~ 23:59,6,6,9,19,840100,28,20230409,21-24,저녁
합계,5111,5111,23681,27585,1649483830,51266,20230409,,
00:00 ~ 2:59,1,1,2,2,80000,4,20230410,0-3,심야
3:00 ~ 5:59,4,4,3,3,-40000,6,20230410,3-6,심야
6:00 ~ 8:59,2,2,1,1,30000,2,20230410,6-9,심야
9:00 ~ 11:59,605,605,1179,3245,95606000,4424,20230410,9-12,주간
12:00 ~ 14:59,1243,1243,6165,9667,737923200,15832,20230410,12-15,주간
15:00 ~ 17:59,1298,1298,4815,9342,533944790,14157,20230410,15-18,주간
18:00 ~ 20:59,2095,2095,14593,16920,999221130,31513,20230410,18-21,저녁
21:00 ~ 23:59,9,9,24,-5,-152200,19,20230410,21-24,저녁
합계,5257,5257,26782,39175,2366612920,65957,20230410,,
00:00 ~ 2:59,1,1,1,-1,-40000,0,20230411,0-3,심야
3:00 ~ 5:59,3,3,0,14,40000,14,20230411,3-6,심야
6:00 ~ 8:59,0,0,0,0,0,0,20230411,6-9,심야
9:00 ~ 11:59,648,648,2555,5180,125558810,7735,20230411,9-12,주간
12:00 ~ 14:59,1300,1300,8835,16389,1096367250,25224,20230411,12-15,주간
15:00 ~ 17:59,1322,1322,7876,13201,636881960,21077,20230411,15-18,주간
18:00 ~ 20:59,2216,2216,24034,37138,2288911670,61172,20230411,18-21,저녁
21:00 ~ 23:59,7,7,9,31,1654480,40,20230411,21-24,저녁
합계,5497,5497,43310,71952,4149374170,115262,20230411,,
00:00 ~ 2:59,1,1,1,0,0,1,20230412,0-3,심야
3:00 ~ 5:59,4,4,1,9,80000,10,20230412,3-6,심야
6:00 ~ 8:59,1,1,1,0,0,1,20230412,6-9,심야
9:00 ~ 11:59,680,680,2568,6225,123082600,8793,20230412,9-12,주간
12:00 ~ 14:59,1392,1392,7499,15621,922685392,23120,20230412,12-15,주간
15:00 ~ 17:59,1355,1355,5480,9734,271439470,15214,20230412,15-18,주간
18:00 ~ 20:59,2222,2222,21160,22577,1579563190,43737,20230412,18-21,저녁
21:00 ~ 23:59,13,13,99,11,1060200,110,20230412,21-24,저녁
합계,5668,5668,36809,54177,2897910852,90986,20230412,,
00:00 ~ 2:59,0,0,0,0,0,0,20230413,0-3,심야
3:00 ~ 5:59,3,3,1,2,35000,3,20230413,3-6,심야
6:00 ~ 8:59,1,1,1,-1,-30000,0,20230413,6-9,심야
9:00 ~ 11:59,651,651,2817,6045,120339250,8862,20230413,9-12,주간
12:00 ~ 14:59,1398,1398,7586,14899,1219289992,22485,20230413,12-15,주간
15:00 ~ 17:59,1361,1361,5713,9704,262203180,15417,20230413,15-18,주간
18:00 ~ 20:59,2324,2324,23311,45748,4029178450,69059,20230413,18-21,저녁
21:00 ~ 23:59,8,8,24,3,345300,27,20230413,21-24,저녁
합계,5746,5746,39453,76400,5631361172,115853,20230413,,
00:00 ~ 2:59,1,1,1,0,0,1,20230414,0-3,심야
3:00 ~ 5:59,4,4,0,8,120000,8,20230414,3-6,심야
6:00 ~ 8:59,0,0,0,0,0,0,20230414,6-9,심야
9:00 ~ 11:59,698,698,3256,4982,119647660,8238,20230414,9-12,주간
12:00 ~ 14:59,1501,1501,11872,12920,530267520,24792,20230414,12-15,주간
15:00 ~ 17:59,1446,1446,5961,13418,284142910,19379,20230414,15-18,주간
18:00 ~ 20:59,2289,2289,26669,21557,652583170,48226,20230414,18-21,저녁
21:00 ~ 23:59,10,10,17,37,1627200,54,20230414,21-24,저녁
합계,5949,5949,47776,52922,1588388460,100698,20230414,,
00:00 ~ 2:59,0,0,0,0,0,0,20230415,0-3,심야
3:00 ~ 5:59,5,5,0,154,40000,154,20230415,3-6,심야
6:00 ~ 8:59,0,0,0,0,0,0,20230415,6-9,심야
9:00 ~ 11:59,646,646,1924,3403,103730130,5327,20230415,9-12,주간
12:00 ~ 14:59,1434,1434,8515,9770,649345632,18285,20230415,12-15,주간
15:00 ~ 17:59,1394,1394,5154,9590,266849330,14744,20230415,15-18,주간
18:00 ~ 20:59,2012,2012,13478,14273,904334562,27751,20230415,18-21,저녁
21:00 ~ 23:59,12,12,7,48,1025280,55,20230415,21-24,저녁
합계,5503,5503,29078,37238,1925324934,66316,20230415,,
00:00 ~ 2:59,0,0,0,0,0,0,20230416,0-3,심야
3:00 ~ 5:59,2,2,0,3,55000,3,20230416,3-6,심야
6:00 ~ 8:59,0,0,0,0,0,0,20230416,6-9,심야
9:00 ~ 11:59,627,627,1305,3562,94700890,4867,20230416,9-12,주간
12:00 ~ 14:59,1359,1359,7869,7810,584274850,15679,20230416,12-15,주간
15:00 ~ 17:59,1305,1305,3373,8229,257575858,11602,20230416,15-18,주간
18:00 ~ 20:59,1940,1940,9026,10248,743762497,19274,20230416,18-21,저녁
21:00 ~ 23:59,5,5,2,22,566280,24,20230416,21-24,저녁
합계,5238,5238,21575,29874,1680935375,51449,20230416,,
00:00 ~ 2:59,0,0,0,0,0,0,20230417,0-3,심야
3:00 ~ 5:59,3,3,0,13,270000,13,20230417,3-6,심야
6:00 ~ 8:59,0,0,0,0,0,0,20230417,6-9,심야
9:00 ~ 11:59,604,604,1135,3186,92348080,4321,20230417,9-12,주간
12:00 ~ 14:59,1308,1308,5422,14442,607562210,19864,20230417,12-15,주간
15:00 ~ 17:59,1351,1351,4035,8895,271549070,12930,20230417,15-18,주간
18:00 ~ 20:59,2189,2189,13317,25746,1204977760,39063,20230417,18-21,저녁
21:00 ~ 23:59,6,6,2,18,528200,20,20230417,21-24,저녁
합계,5461,5461,23911,52300,2177235320,76211,20230417,,
00:00 ~ 2:59,0,0,0,0,0,0,20230418,0-3,심야
3:00 ~ 5:59,3,3,2,8,100000,10,20230418,3-6,심야
6:00 ~ 8:59,2,2,0,7,210000,7,20230418,6-9,심야
9:00 ~ 11:59,651,651,2407,4846,112672300,7253,20230418,9-12,주간
12:00 ~ 14:59,1371,1371,7761,14545,854442732,22306,20230418,12-15,주간
15:00 ~ 17:59,1387,1387,5147,11600,321583210,16747,20230418,15-18,주간
18:00 ~ 20:59,2258,2258,17110,24920,1130788120,42030,20230418,18-21,저녁
21:00 ~ 23:59,10,10,97,13,466640,110,20230418,21-24,저녁
합계,5682,5682,32524,55939,2420263002,88463,20230418,,
00:00 ~ 2:59,0,0,0,0,0,0,20230419,0-3,심야
3:00 ~ 5:59,5,5,3,7,145000,10,20230419,3-6,심야
6:00 ~ 8:59,0,0,0,0,0,0,20230419,6-9,심야
9:00 ~ 11:59,685,685,2963,4238,150272030,7201,20230419,9-12,주간
12:00 ~ 14:59,1352,1352,5634,9826,499414048,15460,20230419,12-15,주간
15:00 ~ 17:59,1374,1374,4892,8589,208073230,13481,20230419,15-18,주간
18:00 ~ 20:59,2290,2290,17468,43801,3473598810,61269,20230419,18-21,저녁
21:00 ~ 23:59,12,12,5,41,887660,46,20230419,21-24,저녁
합계,5718,5718,30965,66502,4332390778,97467,20230419,,
00:00 ~ 2:59,0,0,0,0,0,0,20230420,0-3,심야
3:00 ~ 5:59,3,3,3,5,110000,8,20230420,3-6,심야
6:00 ~ 8:59,0,0,0,0,0,0,20230420,6-9,심야
9:00 ~ 11:59,657,657,3736,2753,122509160,6489,20230420,9-12,주간
12:00 ~ 14:59,1392,1392,7181,9331,600733620,16512,20230420,12-15,주간
15:00 ~ 17:59,1388,1388,4745,11326,499965940,16071,20230420,15-18,주간
18:00 ~ 20:59,2270,2270,16635,27546,1638800920,44181,20230420,18-21,저녁
21:00 ~ 23:59,12,12,9,19,810180,28,20230420,21-24,저녁
합계,5722,5722,32309,50980,2862929820,83289,20230420,,
00:00 ~ 2:59,2,2,0,4,120000,4,20230421,0-3,심야
3:00 ~ 5:59,6,6,2,15,380000,17,20230421,3-6,심야
6:00 ~ 8:59,3,3,0,3,90000,3,20230421,6-9,심야
9:00 ~ 11:59,690,690,2696,3896,132464980,6592,20230421,9-12,주간
12:00 ~ 14:59,1473,1473,7921,10973,538663794,18894,20230421,12-15,주간
15:00 ~ 17:59,1488,1488,4928,13525,306308000,18453,20230421,15-18,주간
18:00 ~ 20:59,2248,2248,15617,26079,1216727740,41696,20230421,18-21,저녁
21:00 ~ 23:59,10,10,5,27,640600,32,20230421,21-24,저녁
합계,5920,5920,31169,54522,2195395114,85691,20230421,,
00:00 ~ 2:59,0,0,0,0,0,0,20230422,0-3,심야
3:00 ~ 5:59,4,4,0,13,290000,13,20230422,3-6,심야
6:00 ~ 8:59,2,2,0,3,90000,3,20230422,6-9,심야
9:00 ~ 11:59,620,620,1763,3087,115803990,4850,20230422,9-12,주간
12:00 ~ 14:59,1403,1403,6411,9000,501459840,15411,20230422,12-15,주간
15:00 ~ 17:59,1383,1383,4681,8947,241232420,13628,20230422,15-18,주간
18:00 ~ 20:59,1945,1945,8484,11859,770996380,20343,20230422,18-21,저녁
21:00 ~ 23:59,8,8,0,34,775500,34,20230422,21-24,저녁
합계,5365,5365,21339,32943,1630648130,54282,20230422,,
00:00 ~ 2:59,0,0,0,0,0,0,20230423,0-3,심야
3:00 ~ 5:59,2,2,2,5,60000,7,20230423,3-6,심야
6:00 ~ 8:59,0,0,0,0,0,0,20230423,6-9,심야
9:00 ~ 11:59,578,578,1815,2731,121459700,4546,20230423,9-12,주간
12:00 ~ 14:59,1326,1326,5928,7816,503951930,13744,20230423,12-15,주간
15:00 ~ 17:59,1324,1324,3366,6482,216438990,9848,20230423,15-18,주간
18:00 ~ 20:59,1952,1952,6840,10297,731671960,17137,20230423,18-21,저녁
21:00 ~ 23:59,1,1,1,13,405000,14,20230423,21-24,저녁
합계,5183,5183,17952,27344,1573987580,45296,20230423,,
00:00 ~ 2:59,0,0,0,0,0,0,20230424,0-3,심야
3:00 ~ 5:59,2,2,0,7,140000,7,20230424,3-6,심야
6:00 ~ 8:59,0,0,0,0,0,0,20230424,6-9,심야
9:00 ~ 11:59,627,627,1867,5803,184885996,7670,20230424,9-12,주간
12:00 ~ 14:59,1294,1294,5583,12712,804666974,18295,20230424,12-15,주간
15:00 ~ 17:59,1393,1393,7094,6298,287159840,13392,20230424,15-18,주간
18:00 ~ 20:59,2121,2121,14553,18589,878508472,33142,20230424,18-21,저녁
21:00 ~ 23:59,3,3,0,9,182650,9,20230424,21-24,저녁
합계,5440,5440,29097,43418,2155543932,72515,20230424,,
00:00 ~ 2:59,1,1,0,22,0,22,20230425,0-3,심야
3:00 ~ 5:59,10,10,0,243,180000,243,20230425,3-6,심야
6:00 ~ 8:59,0,0,0,0,0,0,20230425,6-9,심야
9:00 ~ 11:59,656,656,3466,6041,167075110,9507,20230425,9-12,주간
12:00 ~ 14:59,1387,1387,8671,18969,711701540,27640,20230425,12-15,주간
15:00 ~ 17:59,1457,1457,5908,10936,359722210,16844,20230425,15-18,주간
18:00 ~ 20:59,2256,2256,15730,38839,1058514340,54569,20230425,18-21,저녁
21:00 ~ 23:59,7,7,14,153,2159000,167,20230425,21-24,저녁
합계,5774,5774,33789,75203,2299352200,108992,20230425,,
00:00 ~ 2:59,1,1,0,48,0,48,20230426,0-3,심야
3:00 ~ 5:59,10,10,1,569,215000,570,20230426,3-6,심야
6:00 ~ 8:59,0,0,0,0,0,0,20230426,6-9,심야
9:00 ~ 11:59,685,685,3289,4500,151692154,7789,20230426,9-12,주간
12:00 ~ 14:59,1404,1404,7302,13683,979935062,20985,20230426,12-15,주간
15:00 ~ 17:59,1462,1462,6120,10495,354658180,16615,20230426,15-18,주간
18:00 ~ 20:59,2334,2334,20006,35656,2204703972,55662,20230426,18-21,저녁
21:00 ~ 23:59,9,9,18,86,1424960,104,20230426,21-24,저녁
합계,5905,5905,36736,65037,3692629328,101773,20230426,,
00:00 ~ 2:59,1,1,0,67,0,67,20230427,0-3,심야
3:00 ~ 5:59,10,10,20,655,180000,675,20230427,3-6,심야
6:00 ~ 8:59,0,0,0,0,0,0,20230427,6-9,심야
9:00 ~ 11:59,739,739,3398,4925,165152360,8323,20230427,9-12,주간
12:00 ~ 14:59,1485,1485,13315,14467,1030988190,27782,20230427,12-15,주간
15:00 ~ 17:59,1523,1523,5412,9744,414520630,15156,20230427,15-18,주간
18:00 ~ 20:59,2258,2258,21665,87375,8792608080,109040,20230427,18-21,저녁
21:00 ~ 23:59,11,11,17,49,745830,66,20230427,21-24,저녁
합계,6027,6027,43827,117282,10404195090,161109,20230427,,
00:00 ~ 2:59,1,1,0,40,0,40,20230428,0-3,심야
3:00 ~ 5:59,9,9,15,264,100000,279,20230428,3-6,심야
6:00 ~ 8:59,0,0,0,0,0,0,20230428,6-9,심야
9:00 ~ 11:59,748,748,3599,9303,742654700,12902,20230428,9-12,주간
12:00 ~ 14:59,1524,1524,10656,14941,779073430,25597,20230428,12-15,주간
15:00 ~ 17:59,1542,1542,6358,22521,1830127401,28879,20230428,15-18,주간
18:00 ~ 20:59,2301,2301,23842,58660,4682650132,82502,20230428,18-21,저녁
21:00 ~ 23:59,9,9,18,43,883330,61,20230428,21-24,저녁
합계,6134,6134,44488,105772,8035488993,150260,20230428,,
00:00 ~ 2:59,1,1,0,24,0,24,20230429,0-3,심야
3:00 ~ 5:59,6,6,4,106,40000,110,20230429,3-6,심야
6:00 ~ 8:59,0,0,0,0,0,0,20230429,6-9,심야
9:00 ~ 11:59,645,645,2133,3479,201247080,5612,20230429,9-12,주간
12:00 ~ 14:59,1444,1444,13970,4159,579846460,18129,20230429,12-15,주간
15:00 ~ 17:59,1454,1454,5228,15716,1003690311,20944,20230429,15-18,주간
18:00 ~ 20:59,2007,2007,17606,11061,1344663983,28667,20230429,18-21,저녁
21:00 ~ 23:59,7,7,9,24,512000,33,20230429,21-24,저녁
합계,5564,5564,38950,34569,3129999834,73519,20230429,,
00:00 ~ 2:59,1,1,0,10,0,10,20230430,0-3,심야
3:00 ~ 5:59,4,4,0,52,0,52,20230430,3-6,심야
6:00 ~ 8:59,0,0,0,0,0,0,20230430,6-9,심야
9:00 ~ 11:59,592,592,1780,2863,111957070,4643,20230430,9-12,주간
12:00 ~ 14:59,1356,1356,13386,2881,588890571,16267,20230430,12-15,주간
15:00 ~ 17:59,1333,1333,3512,7648,272691130,11160,20230430,15-18,주간
18:00 ~ 20:59,1923,1923,8767,10486,774096631,19253,20230430,18-21,저녁
21:00 ~ 23:59,8,8,16,54,567440,70,20230430,21-24,저녁
합계,5217,5217,27461,23994,1748202842,51455,20230430,,
00:00 ~ 2:59,1,1,0,10,0,10,20230501,0-3,심야
3:00 ~ 5:59,4,4,0,54,0,54,20230501,3-6,심야
6:00 ~ 8:59,0,0,0,0,0,0,20230501,6-9,심야
9:00 ~ 11:59,603,603,2470,3374,128650170,5844,20230501,9-12,주간
12:00 ~ 14:59,1323,1323,6663,9500,602601800,16163,20230501,12-15,주간
15:00 ~ 17:59,1377,1377,4329,6884,260068680,11213,20230501,15-18,주간
18:00 ~ 20:59,2091,2091,9448,15145,1037638130,24593,20230501,18-21,저녁
21:00 ~ 23:59,8,8,0,31,874590,31,20230501,21-24,저녁
합계,5407,5407,22910,34998,2029833370,57908,20230501,,
00:00 ~ 2:59,1,1,0,16,0,16,20230502,0-3,심야
3:00 ~ 5:59,4,4,0,85,0,85,20230502,3-6,심야
6:00 ~ 8:59,0,0,0,0,0,0,20230502,6-9,심야
9:00 ~ 11:59,690,690,3135,4167,110337590,7302,20230502,9-12,주간
12:00 ~ 14:59,1451,1451,9089,15136,661334570,24225,20230502,12-15,주간
15:00 ~ 17:59,1513,1513,6870,13984,501903800,20854,20230502,15-18,주간
18:00 ~ 20:59,2325,2325,17289,42853,1318608860,60142,20230502,18-21,저녁
21:00 ~ 23:59,11,11,34,17,331020,51,20230502,21-24,저녁
합계,5995,5995,36417,76258,2592515840,112675,20230502,,
00:00 ~ 2:59,1,1,0,16,0,16,20230503,0-3,심야
3:00 ~ 5:59,4,4,0,62,0,62,20230503,3-6,심야
6:00 ~ 8:59,0,0,0,0,0,0,20230503,6-9,심야
9:00 ~ 11:59,700,700,5523,5447,171112740,10970,20230503,9-12,주간
12:00 ~ 14:59,1474,1474,9257,16744,785947759,26001,20230503,12-15,주간
15:00 ~ 17:59,1557,1557,6904,15309,604900890,22213,20230503,15-18,주간
18:00 ~ 20:59,2380,2380,20490,38036,1446092022,58526,20230503,18-21,저녁
21:00 ~ 23:59,10,10,4,40,624840,44,20230503,21-24,저녁
합계,6126,6126,42178,75654,3008678251,117832,20230503,,
00:00 ~ 2:59,1,1,0,2,0,2,20230504,0-3,심야
3:00 ~ 5:59,3,3,0,12,0,12,20230504,3-6,심야
6:00 ~ 8:59,0,0,0,0,0,0,20230504,6-9,심야
9:00 ~ 11:59,729,729,4726,9374,139302880,14100,20230504,9-12,주간
12:00 ~ 14:59,1493,1493,11790,19805,1121898032,31595,20230504,12-15,주간
15:00 ~ 17:59,1550,1550,6624,14467,539261050,21091,20230504,15-18,주간
18:00 ~ 20:59,2364,2364,19879,25637,1385332850,45516,20230504,18-21,저녁
21:00 ~ 23:59,8,8,21,140,6001800,161,20230504,21-24,저녁
합계,6148,6148,43040,69437,3191796612,112477,20230504,,
00:00 ~ 2:59,1,1,0,2,0,2,20230505,0-3,심야
3:00 ~ 5:59,4,4,0,12,0,12,20230505,3-6,심야
6:00 ~ 8:59,0,0,0,0,0,0,20230505,6-9,심야
9:00 ~ 11:59,656,656,3009,4376,104243160,7385,20230505,9-12,주간
12:00 ~ 14:59,1470,1470,9657,13329,741845550,22986,20230505,12-15,주간
15:00 ~ 17:59,1463,1463,6575,9375,342146160,15950,20230505,15-18,주간
18:00 ~ 20:59,2106,2106,16023,11305,839962062,27328,20230505,18-21,저녁
21:00 ~ 23:59,8,8,6,51,1540250,57,20230505,21-24,저녁
합계,5708,5708,35270,38450,2029737182,73720,20230505,,
00:00 ~ 2:59,1,1,0,4,0,4,20230506,0-3,심야
3:00 ~ 5:59,4,4,0,16,0,16,20230506,3-6,심야
6:00 ~ 8:59,0,0,0,0,0,0,20230506,6-9,심야
9:00 ~ 11:59,633,633,2365,4990,104517450,7355,20230506,9-12,주간
12:00 ~ 14:59,1289,1289,9866,9934,622368110,19800,20230506,12-15,주간
15:00 ~ 17:59,1345,1345,5169,8474,302863660,13643,20230506,15-18,주간
18:00 ~ 20:59,1996,1996,13228,9271,768189730,22499,20230506,18-21,저녁
21:00 ~ 23:59,10,10,7,63,2096500,70,20230506,21-24,저녁
합계,5278,5278,30635,32752,1800035450,63387,20230506,,
00:00 ~ 2:59,0,0,0,0,0,0,20230507,0-3,심야
3:00 ~ 5:59,3,3,0,10,0,10,20230507,3-6,심야
6:00 ~ 8:59,0,0,0,0,0,0,20230507,6-9,심야
9:00 ~ 11:59,525,525,1656,2005,70532660,3661,20230507,9-12,주간
12:00 ~ 14:59,1177,1177,7854,6445,588542650,14299,20230507,12-15,주간
15:00 ~ 17:59,1190,1190,3180,6002,228324061,9182,20230507,15-18,주간
18:00 ~ 20:59,1887,1887,8406,9252,706177390,17658,20230507,18-21,저녁
21:00 ~ 23:59,8,8,14,38,1361250,52,20230507,21-24,저녁
합계,4790,4790,21110,23752,1594938011,44862,20230507,,
00:00 ~ 2:59,1,1,0,2,0,2,20230508,0-3,심야
3:00 ~ 5:59,4,4,0,8,0,8,20230508,3-6,심야
6:00 ~ 8:59,0,0,0,0,0,0,20230508,6-9,심야
9:00 ~ 11:59,560,560,1643,2820,72682490,4463,20230508,9-12,주간
12:00 ~ 14:59,1148,1148,4973,8702,504092770,13675,20230508,12-15,주간
15:00 ~ 17:59,1262,1262,4982,13288,1133195530,18270,20230508,15-18,주간
18:00 ~ 20:59,2148,2148,15330,33507,1691263520,48837,20230508,18-21,저녁
21:00 ~ 23:59,7,7,9,25,1023350,34,20230508,21-24,저녁
합계,5130,5130,26937,58352,3402257660,85289,20230508,,
00:00 ~ 2:59,1,1,0,2,0,2,20230509,0-3,심야
3:00 ~ 5:59,4,4,0,20,0,20,20230509,3-6,심야
6:00 ~ 8:59,0,0,0,0,0,0,20230509,6-9,심야
9:00 ~ 11:59,626,626,1686,4019,86172570,5705,20230509,9-12,주간
12:00 ~ 14:59,1209,1209,8029,13602,922988454,21631,20230509,12-15,주간
15:00 ~ 17:59,1322,1322,6371,13132,732635876,19503,20230509,15-18,주간
18:00 ~ 20:59,2325,2325,21417,52291,4694558546,73708,20230509,18-21,저녁
21:00 ~ 23:59,10,10,12,36,1545630,48,20230509,21-24,저녁
합계,5497,5497,37515,83102,6437901076,120617,20230509,,
00:00 ~ 2:59,0,0,0,0,0,0,20230510,0-3,심야
3:00 ~ 5:59,0,0,0,0,0,0,20230510,3-6,심야
6:00 ~ 8:59,0,0,0,0,0,0,20230510,6-9,심야
9:00 ~ 11:59,585,585,1933,3510,85822680,5443,20230510,9-12,주간
12:00 ~ 14:59,1233,1233,7681,12328,763786662,20009,20230510,12-15,주간
15:00 ~ 17:59,1354,1354,6177,13499,591796530,19676,20230510,15-18,주간
18:00 ~ 20:59,2307,2307,19009,42881,3052417551,61890,20230510,18-21,저녁
21:00 ~ 23:59,10,10,11,50,1422000,61,20230510,21-24,저녁
합계,5489,5489,34811,72268,4495245423,107079,20230510,,
00:00 ~ 2:59,1,1,0,2,0,2,20230511,0-3,심야
3:00 ~ 5:59,2,2,0,4,0,4,20230511,3-6,심야
6:00 ~ 8:59,0,0,0,0,0,0,20230511,6-9,심야
9:00 ~ 11:59,608,608,2177,4200,67653430,6377,20230511,9-12,주간
12:00 ~ 14:59,1267,1267,10597,13602,614594986,24199,20230511,12-15,주간
15:00 ~ 17:59,1370,1370,6552,12878,723841276,19430,20230511,15-18,주간
18:00 ~ 20:59,2354,2354,25542,42301,2111550042,67843,20230511,18-21,저녁
21:00 ~ 23:59,8,8,8,63,2076880,71,20230511,21-24,저녁
합계,5610,5610,44876,73050,3519716614,117926,20230511,,
00:00 ~ 2:59,0,0,0,0,0,0,20230512,0-3,심야
3:00 ~ 5:59,2,2,0,12,0,12,20230512,3-6,심야
6:00 ~ 8:59,0,0,0,0,0,0,20230512,6-9,심야
9:00 ~ 11:59,613,613,2840,9880,1249371227,12720,20230512,9-12,주간
12:00 ~ 14:59,1272,1272,8027,14360,735262810,22387,20230512,12-15,주간
15:00 ~ 17:59,1389,1389,6200,19622,1268896458,25822,20230512,15-18,주간
18:00 ~ 20:59,2292,2292,21555,43335,2022381027,64890,20230512,18-21,저녁
21:00 ~ 23:59,10,10,14,44,1255350,58,20230512,21-24,저녁
합계,5578,5578,38636,87253,5277166872,125889,20230512,,
00:00 ~ 2:59,0,0,0,0,0,0,20230513,0-3,심야
3:00 ~ 5:59,0,0,0,0,0,0,20230513,3-6,심야
6:00 ~ 8:59,0,0,0,0,0,0,20230513,6-9,심야
9:00 ~ 11:59,570,570,1529,2917,162227910,4446,20230513,9-12,주간
12:00 ~ 14:59,1247,1247,7747,8574,485667890,16321,20230513,12-15,주간
15:00 ~ 17:59,1346,1346,4756,11060,503063344,15816,20230513,15-18,주간
18:00 ~ 20:59,1997,1997,15230,10269,884776268,25499,20230513,18-21,저녁
21:00 ~ 23:59,8,8,15,44,1126070,59,20230513,21-24,저녁
합계,5168,5168,29277,32864,2036861482,62141,20230513,,
00:00 ~ 2:59,1,1,0,2,0,2,20230514,0-3,심야
3:00 ~ 5:59,3,3,0,8,0,8,20230514,3-6,심야
6:00 ~ 8:59,0,0,0,0,0,0,20230514,6-9,심야
9:00 ~ 11:59,518,518,1479,2134,50059660,3613,20230514,9-12,주간
12:00 ~ 14:59,1141,1141,8043,7924,519816100,15967,20230514,12-15,주간
15:00 ~ 17:59,1208,1208,3647,7531,284344710,11178,20230514,15-18,주간
18:00 ~ 20:59,1949,1949,11511,10616,713162820,22127,20230514,18-21,저녁
21:00 ~ 23:59,8,8,5,28,722630,33,20230514,21-24,저녁
합계,4828,4828,24685,28243,1568105920,52928,20230514,,
00:00 ~ 2:59,0,0,0,0,0,0,20230515,0-3,심야
3:00 ~ 5:59,0,0,0,0,0,0,20230515,3-6,심야
6:00 ~ 8:59,0,0,0,0,0,0,20230515,6-9,심야
9:00 ~ 11:59,530,530,2057,4391,126104330,6448,20230515,9-12,주간
12:00 ~ 14:59,1069,1069,5464,6759,458845816,12223,20230515,12-15,주간
15:00 ~ 17:59,1262,1262,4260,10084,648488759,14344,20230515,15-18,주간
18:00 ~ 20:59,2133,2133,16486,21756,1568922110,38242,20230515,18-21,저녁
21:00 ~ 23:59,9,9,10,23,448600,33,20230515,21-24,저녁
합계,5003,5003,28277,43013,2802809615,71290,20230515,,
00:00 ~ 2:59,0,0,0,0,0,0,20230516,0-3,심야
3:00 ~ 5:59,4,4,0,13,0,13,20230516,3-6,심야
6:00 ~ 8:59,0,0,0,0,0,0,20230516,6-9,심야
9:00 ~ 11:59,573,573,3574,2507,19727700,6081,20230516,9-12,주간
12:00 ~ 14:59,1138,1138,6459,8431,481972190,14890,20230516,12-15,주간
15:00 ~ 17:59,1361,1361,5232,19381,843548701,24613,20230516,15-18,주간
18:00 ~ 20:59,2368,2368,18456,40824,2100604470,59280,20230516,18-21,저녁
21:00 ~ 23:59,11,11,26,19,642290,45,20230516,21-24,저녁
합계,5455,5455,33747,71175,3446495351,104922,20230516,,
00:00 ~ 2:59,0,0,0,0,0,0,20230517,0-3,심야
3:00 ~ 5:59,0,0,0,0,0,0,20230517,3-6,심야
6:00 ~ 8:59,0,0,0,0,0,0,20230517,6-9,심야
9:00 ~ 11:59,604,604,3242,3562,53307260,6804,20230517,9-12,주간
12:00 ~ 14:59,1226,1226,5540,10325,778486294,15865,20230517,12-15,주간
15:00 ~ 17:59,1375,1375,5313,9278,426875288,14591,20230517,15-18,주간
18:00 ~ 20:59,2304,2304,19121,45792,3670834480,64913,20230517,18-21,저녁
21:00 ~ 23:59,12,12,10,53,1432690,63,20230517,21-24,저녁
합계,5521,5521,33226,69010,4930936012,102236,20230517,,
00:00 ~ 2:59,0,0,0,0,0,0,20230518,0-3,심야
3:00 ~ 5:59,3,3,0,13,0,13,20230518,3-6,심야
6:00 ~ 8:59,0,0,0,0,0,0,20230518,6-9,심야
9:00 ~ 11:59,629,629,2163,2959,64617370,5122,20230518,9-12,주간
12:00 ~ 14:59,1248,1248,6382,13166,1071652900,19548,20230518,12-15,주간
15:00 ~ 17:59,1383,1383,5428,12536,680773921,17964,20230518,15-18,주간
18:00 ~ 20:59,2318,2318,24771,60748,4988498030,85519,20230518,18-21,저녁
21:00 ~ 23:59,13,13,10,38,1000620,48,20230518,21-24,저녁
합계,5594,5594,38754,89460,6806542841,128214,20230518,,
00:00 ~ 2:59,0,0,0,0,0,0,20230519,0-3,심야
3:00 ~ 5:59,0,0,0,0,0,0,20230519,3-6,심야
6:00 ~ 8:59,0,0,0,0,0,0,20230519,6-9,심야
9:00 ~ 11:59,645,645,2670,5428,66331540,8098,20230519,9-12,주간
12:00 ~ 14:59,1293,1293,7598,14877,741005812,22475,20230519,12-15,주간
15:00 ~ 17:59,1444,1444,6331,13836,552154999,20167,20230519,15-18,주간
18:00 ~ 20:59,2323,2323,27122,34843,1920316680,61965,20230519,18-21,저녁
21:00 ~ 23:59,8,8,7,48,1557150,55,20230519,21-24,저녁
합계,5713,5713,43728,69032,3281366181,112760,20230519,,
00:00 ~ 2:59,0,0,0,0,0,0,20230520,0-3,심야
3:00 ~ 5:59,1,1,0,2,0,2,20230520,3-6,심야
6:00 ~ 8:59,0,0,0,0,0,0,20230520,6-9,심야
9:00 ~ 11:59,589,589,1850,2603,78418070,4453,20230520,9-12,주간
12:00 ~ 14:59,1269,1269,8926,7920,632757502,16846,20230520,12-15,주간
15:00 ~ 17:59,1385,1385,5161,10346,372980650,15507,20230520,15-18,주간
18:00 ~ 20:59,2090,2090,14801,14574,1023798870,29375,20230520,18-21,저녁
21:00 ~ 23:59,9,9,6,33,716000,39,20230520,21-24,저녁
합계,5343,5343,30744,35478,2108671092,66222,20230520,,
00:00 ~ 2:59,0,0,0,0,0,0,20230521,0-3,심야
3:00 ~ 5:59,0,0,0,0,0,0,20230521,3-6,심야
6:00 ~ 8:59,0,0,0,0,0,0,20230521,6-9,심야
9:00 ~ 11:59,523,523,1533,1996,70278430,3529,20230521,9-12,주간
12:00 ~ 14:59,1147,1147,9099,3511,405241390,12610,20230521,12-15,주간
15:00 ~ 17:59,1213,1213,3543,6621,280320500,10164,20230521,15-18,주간
18:00 ~ 20:59,1943,1943,14980,7108,579975680,22088,20230521,18-21,저녁
21:00 ~ 23:59,7,7,5,31,1041100,36,20230521,21-24,저녁
합계,4833,4833,29160,19267,1336857100,48427,20230521,,
00:00 ~ 2:59,0,0,0,0,0,0,20230522,0-3,심야
3:00 ~ 5:59,0,0,0,0,0,0,20230522,3-6,심야
6:00 ~ 8:59,0,0,0,0,0,0,20230522,6-9,심야
9:00 ~ 11:59,548,548,2244,2399,63660250,4643,20230522,9-12,주간
12:00 ~ 14:59,1140,1140,4741,9881,475650652,14622,20230522,12-15,주간
15:00 ~ 17:59,1319,1319,4409,13800,642989190,18209,20230522,15-18,주간
18:00 ~ 20:59,2282,2282,16217,26283,1471921642,42500,20230522,18-21,저녁
21:00 ~ 23:59,7,7,0,19,676380,19,20230522,21-24,저녁
합계,5296,5296,27611,52382,2654898114,79993,20230522,,
00:00 ~ 2:59,0,0,0,0,0,0,20230523,0-3,심야
3:00 ~ 5:59,1,1,0,2,0,2,20230523,3-6,심야
6:00 ~ 8:59,0,0,0,0,0,0,20230523,6-9,심야
9:00 ~ 11:59,576,576,2270,2801,10412970,5071,20230523,9-12,주간
12:00 ~ 14:59,1182,1182,6632,14082,1179891770,20714,20230523,12-15,주간
15:00 ~ 17:59,1342,1342,5557,12200,619901250,17757,20230523,15-18,주간
18:00 ~ 20:59,2350,2350,28336,43652,2785335820,71988,20230523,18-21,저녁
21:00 ~ 23:59,13,13,11,36,1281160,47,20230523,21-24,저녁
합계,5464,5464,42806,72773,4596822970,115579,20230523,,
00:00 ~ 2:59,0,0,0,0,0,0,20230524,0-3,심야
3:00 ~ 5:59,0,0,0,0,0,0,20230524,3-6,심야
6:00 ~ 8:59,0,0,0,0,0,0,20230524,6-9,심야
9:00 ~ 11:59,560,560,1938,3017,35253140,4955,20230524,9-12,주간
12:00 ~ 14:59,1210,1210,7504,9980,559961028,17484,20230524,12-15,주간
15:00 ~ 17:59,1370,1370,5596,12414,767365260,18010,20230524,15-18,주간
18:00 ~ 20:59,2308,2308,18980,30924,2131151760,49904,20230524,18-21,저녁
21:00 ~ 23:59,7,7,10,8,290380,18,20230524,21-24,저녁
합계,5455,5455,34028,56343,3494021568,90371,20230524,,
00:00 ~ 2:59,0,0,0,0,0,0,20230525,0-3,심야
3:00 ~ 5:59,1,1,0,50,0,50,20230525,3-6,심야
6:00 ~ 8:59,0,0,0,0,0,0,20230525,6-9,심야
9:00 ~ 11:59,698,698,2900,8465,47633310,11365,20230525,9-12,주간
12:00 ~ 14:59,1332,1332,8810,16701,680801108,25511,20230525,12-15,주간
15:00 ~ 17:59,1485,1485,7398,15969,689887485,23367,20230525,15-18,주간
18:00 ~ 20:59,2414,2414,25472,33568,1647449790,59040,20230525,18-21,저녁
21:00 ~ 23:59,11,11,7,23,457590,30,20230525,21-24,저녁
합계,5941,5941,44587,74776,3066229283,119363,20230525,,
00:00 ~ 2:59,0,0,0,0,0,0,20230526,0-3,심야
3:00 ~ 5:59,0,0,0,0,0,0,20230526,3-6,심야
6:00 ~ 8:59,0,0,0,0,0,0,20230526,6-9,심야
9:00 ~ 11:59,674,674,3250,10652,976762600,13902,20230526,9-12,주간
12:00 ~ 14:59,1343,1343,7570,13849,635389960,21419,20230526,12-15,주간
15:00 ~ 17:59,1488,1488,8023,14301,649900500,22324,20230526,15-18,주간
18:00 ~ 20:59,2317,2317,26178,35674,2209856840,61852,20230526,18-21,저녁
21:00 ~ 23:59,12,12,9,46,944150,55,20230526,21-24,저녁
합계,5834,5834,45030,74522,4472854050,119552,20230526,,
00:00 ~ 2:59,0,0,0,0,0,0,20230527,0-3,심야
3:00 ~ 5:59,0,0,0,0,0,0,20230527,3-6,심야
6:00 ~ 8:59,0,0,0,0,0,0,20230527,6-9,심야
9:00 ~ 11:59,609,609,1361,3896,148418740,5257,20230527,9-12,주간
12:00 ~ 14:59,1288,1288,11155,6047,513181720,17202,20230527,12-15,주간
15:00 ~ 17:59,1426,1426,5243,10686,397499270,15929,20230527,15-18,주간
18:00 ~ 20:59,2052,2052,16792,10913,944393140,27705,20230527,18-21,저녁
21:00 ~ 23:59,10,10,7,66,1324340,73,20230527,21-24,저녁
합계,5385,5385,34558,31608,2004817210,66166,20230527,,
00:00 ~ 2:59,0,0,0,0,0,0,20230528,0-3,심야
3:00 ~ 5:59,0,0,0,0,0,0,20230528,3-6,심야
6:00 ~ 8:59,0,0,0,0,0,0,20230528,6-9,심야
9:00 ~ 11:59,560,560,1180,2409,53952060,3589,20230528,9-12,주간
12:00 ~ 14:59,1161,1161,9860,5390,457703910,15250,20230528,12-15,주간
15:00 ~ 17:59,1236,1236,4076,9843,368308088,13919,20230528,15-18,주간
18:00 ~ 20:59,1951,1951,14597,6866,720486740,21463,20230528,18-21,저녁
21:00 ~ 23:59,9,9,1,31,724350,32,20230528,21-24,저녁
합계,4917,4917,29714,24539,1601175148,54253,20230528,,
00:00 ~ 2:59,0,0,0,0,0,0,20230529,0-3,심야
3:00 ~ 5:59,0,0,0,0,0,0,20230529,3-6,심야
6:00 ~ 8:59,0,0,0,0,0,0,20230529,6-9,심야
9:00 ~ 11:59,531,531,1157,1978,39629210,3135,20230529,9-12,주간
12:00 ~ 14:59,1045,1045,4517,5427,355957270,9944,20230529,12-15,주간
15:00 ~ 17:59,1228,1228,3237,5972,234067060,9209,20230529,15-18,주간
18:00 ~ 20:59,1959,1959,9286,9484,527298840,18770,20230529,18-21,저녁
21:00 ~ 23:59,6,6,10,11,203500,21,20230529,21-24,저녁
합계,4769,4769,18207,22872,1157155880,41079,20230529,,
00:00 ~ 2:59,1,1,0,28,0,28,20230530,0-3,심야
3:00 ~ 5:59,4,4,1,172,0,173,20230530,3-6,심야
6:00 ~ 8:59,0,0,0,0,0,0,20230530,6-9,심야
9:00 ~ 11:59,568,568,2270,4192,138054750,6462,20230530,9-12,주간
12:00 ~ 14:59,1192,1192,7173,9765,719632910,16938,20230530,12-15,주간
15:00 ~ 17:59,1368,1368,5334,14267,738370600,19601,20230530,15-18,주간
18:00 ~ 20:59,2300,2300,27539,40135,3327078240,67674,20230530,18-21,저녁
21:00 ~ 23:59,12,12,4,37,882660,41,20230530,21-24,저녁
합계,5445,5445,42321,68596,4924019160,110917,20230530,,
00:00 ~ 2:59,1,1,0,86,0,86,20230531,0-3,심야
3:00 ~ 5:59,4,4,4,436,0,440,20230531,3-6,심야
6:00 ~ 8:59,0,0,0,0,0,0,20230531,6-9,심야
9:00 ~ 11:59,627,627,2255,6724,87860140,8979,20230531,9-12,주간
12:00 ~ 14:59,1222,1222,5450,12571,549279640,18021,20230531,12-15,주간
15:00 ~ 17:59,1396,1396,6461,13594,705369504,20055,20230531,15-18,주간
18:00 ~ 20:59,2289,2289,22475,23979,1482612966,46454,20230531,18-21,저녁
21:00 ~ 23:59,10,10,20,27,600380,47,20230531,21-24,저녁
합계,5549,5549,36665,57417,2825722630,94082,20230531,,
00:00 ~ 2:59,1,1,2,96,0,98,20230601,0-3,심야
3:00 ~ 5:59,4,4,0,356,0,356,20230601,3-6,심야
6:00 ~ 8:59,0,0,0,0,0,0,20230601,6-9,심야
9:00 ~ 11:59,698,698,2177,5819,112034830,7996,20230601,9-12,주간
12:00 ~ 14:59,1367,1367,6404,16937,581701890,23341,20230601,12-15,주간
15:00 ~ 17:59,1572,1572,6702,15526,725329200,22228,20230601,15-18,주간
18:00 ~ 20:59,2452,2452,19935,30302,1516317770,50237,20230601,18-21,저녁
21:00 ~ 23:59,12,12,6,37,1186100,43,20230601,21-24,저녁
합계,6106,6106,35226,69073,2936569790,104299,20230601,,
00:00 ~ 2:59,1,1,0,36,0,36,20230602,0-3,심야
3:00 ~ 5:59,2,2,0,84,0,84,20230602,3-6,심야
6:00 ~ 8:59,1,1,82,504,7450000,586,20230602,6-9,심야
9:00 ~ 11:59,689,689,3930,12358,1000632030,16288,20230602,9-12,주간
12:00 ~ 14:59,1381,1381,6381,13045,562223080,19426,20230602,12-15,주간
15:00 ~ 17:59,1529,1529,6147,12967,518834420,19114,20230602,15-18,주간
18:00 ~ 20:59,2290,2290,16572,23964,1299526950,40536,20230602,18-21,저녁
21:00 ~ 23:59,9,9,12,27,758400,39,20230602,21-24,저녁
합계,5902,5902,33124,62985,3389424880,96109,20230602,,
00:00 ~ 2:59,1,1,0,10,0,10,20230603,0-3,심야
3:00 ~ 5:59,2,2,1,32,0,33,20230603,3-6,심야
6:00 ~ 8:59,1,1,3,46,435000,49,20230603,6-9,심야
9:00 ~ 11:59,603,603,1735,3880,169920720,5615,20230603,9-12,주간
12:00 ~ 14:59,1284,1284,5490,8157,429383280,13647,20230603,12-15,주간
15:00 ~ 17:59,1423,1423,5435,10527,432954580,15962,20230603,15-18,주간
18:00 ~ 20:59,1973,1973,10055,9696,761692348,19751,20230603,18-21,저녁
21:00 ~ 23:59,9,9,2,46,994740,48,20230603,21-24,저녁
합계,5296,5296,22721,32394,1795380668,55115,20230603,,
00:00 ~ 2:59,1,1,0,10,0,10,20230604,0-3,심야
3:00 ~ 5:59,2,2,0,24,0,24,20230604,3-6,심야
6:00 ~ 8:59,1,1,0,4,50000,4,20230604,6-9,심야
9:00 ~ 11:59,543,543,1581,2953,127486110,4534,20230604,9-12,주간
12:00 ~ 14:59,1154,1154,5856,6388,383818920,12244,20230604,12-15,주간
15:00 ~ 17:59,1290,1290,4175,8488,350298020,12663,20230604,15-18,주간
18:00 ~ 20:59,1906,1906,8319,8365,578448630,16684,20230604,18-21,저녁
21:00 ~ 23:59,9,9,5,21,650000,26,20230604,21-24,저녁
합계,4906,4906,19936,26253,1440751680,46189,20230604,,
00:00 ~ 2:59,1,1,0,14,0,14,20230605,0-3,심야
3:00 ~ 5:59,2,2,0,38,0,38,20230605,3-6,심야
6:00 ~ 8:59,1,1,2,1,10000,3,20230605,6-9,심야
9:00 ~ 11:59,597,597,1640,4215,127748940,5855,20230605,9-12,주간
12:00 ~ 14:59,1130,1130,5093,9970,689110592,15063,20230605,12-15,주간
15:00 ~ 17:59,1364,1364,4625,24904,2562564419,29529,20230605,15-18,주간
18:00 ~ 20:59,2105,2105,12455,42288,4481147162,54743,20230605,18-21,저녁
21:00 ~ 23:59,7,7,6,10,317100,16,20230605,21-24,저녁
합계,5207,5207,23821,81440,7860898213,105261,20230605,,
00:00 ~ 2:59,1,1,0,6,0,6,20230606,0-3,심야
3:00 ~ 5:59,3,3,0,33,0,33,20230606,3-6,심야
6:00 ~ 8:59,0,0,0,0,0,0,20230606,6-9,심야
9:00 ~ 11:59,586,586,1536,2471,82984290,4007,20230606,9-12,주간
12:00 ~ 14:59,1142,1142,5376,5623,393234761,10999,20230606,12-15,주간
15:00 ~ 17:59,1276,1276,4247,9570,673963550,13817,20230606,15-18,주간
18:00 ~ 20:59,1965,1965,9486,13477,1275928910,22963,20230606,18-21,저녁
21:00 ~ 23:59,9,9,2,47,1205350,49,20230606,21-24,저녁
합계,4982,4982,20647,31227,2427316861,51874,20230606,,
00:00 ~ 2:59,1,1,5,18,0,23,20230607,0-3,심야
3:00 ~ 5:59,1,1,0,12,0,12,20230607,3-6,심야
6:00 ~ 8:59,1,1,0,5,100000,5,20230607,6-9,심야
9:00 ~ 11:59,600,600,2266,4572,112451250,6838,20230607,9-12,주간
12:00 ~ 14:59,1145,1145,5445,10439,552638640,15884,20230607,12-15,주간
15:00 ~ 17:59,1397,1397,5889,10554,377665381,16443,20230607,15-18,주간
18:00 ~ 20:59,2267,2267,50172,346847,52831149920,397019,20230607,18-21,저녁
21:00 ~ 23:59,10,10,4,32,787720,36,20230607,21-24,저녁
합계,5422,5422,63781,372479,53874792911,436260,20230607,,
00:00 ~ 2:59,0,0,0,0,0,0,20230608,0-3,심야
3:00 ~ 5:59,1,1,0,6,0,6,20230608,3-6,심야
6:00 ~ 8:59,0,0,0,0,0,0,20230608,6-9,심야
9:00 ~ 11:59,674,674,2580,5628,99361070,8208,20230608,9-12,주간
12:00 ~ 14:59,1205,1205,5016,11629,601888940,16645,20230608,12-15,주간
15:00 ~ 17:59,1449,1449,6325,14529,728556000,20854,20230608,15-18,주간
18:00 ~ 20:59,2326,2326,66907,112300,10266446861,179207,20230608,18-21,저녁
21:00 ~ 23:59,14,14,68,38,704950,106,20230608,21-24,저녁
합계,5669,5669,80896,144130,11696957821,225026,20230608,,
00:00 ~ 2:59,0,0,0,0,0,0,20230609,0-3,심야
3:00 ~ 5:59,2,2,0,11,0,11,20230609,3-6,심야
6:00 ~ 8:59,0,0,0,0,0,0,20230609,6-9,심야
9:00 ~ 11:59,631,631,2693,4545,136235480,7238,20230609,9-12,주간
12:00 ~ 14:59,1197,1197,6140,10824,550154520,16964,20230609,12-15,주간
15:00 ~ 17:59,1474,1474,6226,13004,552752200,19230,20230609,15-18,주간
18:00 ~ 20:59,2289,2289,42973,47015,3253598040,89988,20230609,18-21,저녁
21:00 ~ 23:59,7,7,7,31,420200,38,20230609,21-24,저녁
합계,5600,5600,58039,75430,4493160440,133469,20230609,,
00:00 ~ 2:59,0,0,0,0,0,0,20230610,0-3,심야
3:00 ~ 5:59,1,1,0,4,0,4,20230610,3-6,심야
6:00 ~ 8:59,0,0,0,0,0,0,20230610,6-9,심야
9:00 ~ 11:59,603,603,1328,3346,101743610,4674,20230610,9-12,주간
12:00 ~ 14:59,1156,1156,5055,7175,380938050,12230,20230610,12-15,주간
15:00 ~ 17:59,1344,1344,6123,9697,391360000,15820,20230610,15-18,주간
18:00 ~ 20:59,1952,1952,25163,19569,1292525542,44732,20230610,18-21,저녁
21:00 ~ 23:59,13,13,6,73,1599050,79,20230610,21-24,저녁
합계,5069,5069,37675,39864,2168166252,77539,20230610,,
00:00 ~ 2:59,0,0,0,0,0,0,20230611,0-3,심야
3:00 ~ 5:59,1,1,0,2,0,2,20230611,3-6,심야
6:00 ~ 8:59,0,0,0,0,0,0,20230611,6-9,심야
9:00 ~ 11:59,535,535,1340,2423,79878870,3763,20230611,9-12,주간
12:00 ~ 14:59,1072,1072,6673,4871,351558026,11544,20230611,12-15,주간
15:00 ~ 17:59,1232,1232,5033,6250,265361810,11283,20230611,15-18,주간
18:00 ~ 20:59,1902,1902,25954,7489,359598870,33443,20230611,18-21,저녁
21:00 ~ 23:59,8,8,10,30,725500,40,20230611,21-24,저녁
합계,4750,4750,39010,21065,1057123076,60075,20230611,,
00:00 ~ 2:59,0,0,0,0,0,0,20230612,0-3,심야
3:00 ~ 5:59,0,0,0,0,0,0,20230612,3-6,심야
6:00 ~ 8:59,0,0,0,0,0,0,20230612,6-9,심야
9:00 ~ 11:59,558,558,1224,3841,79753670,5065,20230612,9-12,주간
12:00 ~ 14:59,1040,1040,4470,6290,366589270,10760,20230612,12-15,주간
15:00 ~ 17:59,1298,1298,6309,9558,439422940,15867,20230612,15-18,주간
18:00 ~ 20:59,2115,2115,31714,21894,812973180,53608,20230612,18-21,저녁
21:00 ~ 23:59,9,9,8,16,162440,24,20230612,21-24,저녁
합계,5020,5020,43725,41599,1698901500,85324,20230612,,
00:00 ~ 2:59,0,0,0,0,0,0,20230613,0-3,심야
3:00 ~ 5:59,1,1,0,2,0,2,20230613,3-6,심야
6:00 ~ 8:59,0,0,0,0,0,0,20230613,6-9,심야
9:00 ~ 11:59,599,599,1579,4240,130169110,5819,20230613,9-12,주간
12:00 ~ 14:59,1091,1091,4167,8659,408421682,12826,20230613,12-15,주간
15:00 ~ 17:59,1344,1344,5276,12243,388629360,17519,20230613,15-18,주간
18:00 ~ 20:59,2198,2198,29082,25482,994519320,54564,20230613,18-21,저녁
21:00 ~ 23:59,10,10,3,59,1119330,62,20230613,21-24,저녁
합계,5243,5243,40107,50685,1922858802,90792,20230613,,
00:00 ~ 2:59,0,0,0,0,0,0,20230614,0-3,심야
3:00 ~ 5:59,1,1,0,6,0,6,20230614,3-6,심야
6:00 ~ 8:59,0,0,0,0,0,0,20230614,6-9,심야
9:00 ~ 11:59,654,654,1974,5009,127485710,6983,20230614,9-12,주간
12:00 ~ 14:59,1189,1189,5232,11994,847310032,17226,20230614,12-15,주간
15:00 ~ 17:59,1403,1403,6229,13622,1008854080,19851,20230614,15-18,주간
18:00 ~ 20:59,2239,2239,36171,30366,2273788720,66537,20230614,18-21,저녁
21:00 ~ 23:59,9,9,5,48,1156340,53,20230614,21-24,저녁
합계,5495,5495,49611,61045,4258594882,110656,20230614,,
00:00 ~ 2:59,0,0,0,0,0,0,20230615,0-3,심야
3:00 ~ 5:59,1,1,0,1,0,1,20230615,3-6,심야
6:00 ~ 8:59,0,0,0,0,0,0,20230615,6-9,심야
9:00 ~ 11:59,612,612,1915,4246,96535640,6161,20230615,9-12,주간
12:00 ~ 14:59,1204,1204,5679,13119,1089276865,18798,20230615,12-15,주간
15:00 ~ 17:59,1411,1411,6782,14152,689175365,20934,20230615,15-18,주간
18:00 ~ 20:59,2221,2221,28410,32035,2495911720,60445,20230615,18-21,저녁
21:00 ~ 23:59,13,13,9,34,713580,43,20230615,21-24,저녁
합계,5462,5462,42795,63587,4371613170,106382,20230615,,
00:00 ~ 2:59,0,0,0,0,0,0,20230616,0-3,심야
3:00 ~ 5:59,1,1,0,2,0,2,20230616,3-6,심야
6:00 ~ 8:59,0,0,0,0,0,0,20230616,6-9,심야
9:00 ~ 11:59,647,647,2165,5816,177971360,7981,20230616,9-12,주간
12:00 ~ 14:59,1245,1245,7570,13520,884949340,21090,20230616,12-15,주간
15:00 ~ 17:59,1511,1511,7068,15169,481492680,22237,20230616,15-18,주간
18:00 ~ 20:59,2299,2299,26260,40390,2453472172,66650,20230616,18-21,저녁
21:00 ~ 23:59,12,12,10,39,804060,49,20230616,21-24,저녁
합계,5715,5715,43073,74936,3998689612,118009,20230616,,
00:00 ~ 2:59,0,0,0,0,0,0,20230617,0-3,심야
3:00 ~ 5:59,1,1,0,2,0,2,20230617,3-6,심야
6:00 ~ 8:59,0,0,0,0,0,0,20230617,6-9,심야
9:00 ~ 11:59,603,603,1725,8452,103670880,10177,20230617,9-12,주간
12:00 ~ 14:59,1162,1162,6352,11740,537798870,18092,20230617,12-15,주간
15:00 ~ 17:59,1370,1370,4655,11214,329954460,15869,20230617,15-18,주간
18:00 ~ 20:59,1990,1990,14410,16066,1212376714,30476,20230617,18-21,저녁
21:00 ~ 23:59,14,14,8,61,1385540,69,20230617,21-24,저녁
합계,5140,5140,27150,47535,2185186464,74685,20230617,,
00:00 ~ 2:59,0,0,0,0,0,0,20230618,0-3,심야
3:00 ~ 5:59,2,2,0,6,71600,6,20230618,3-6,심야
6:00 ~ 8:59,0,0,0,0,0,0,20230618,6-9,심야
9:00 ~ 11:59,560,560,1190,2304,77028870,3494,20230618,9-12,주간
12:00 ~ 14:59,1102,1102,5750,6199,401233420,11949,20230618,12-15,주간
15:00 ~ 17:59,1226,1226,3558,6572,280303230,10130,20230618,15-18,주간
18:00 ~ 20:59,1866,1866,12878,11020,875802470,23898,20230618,18-21,저녁
21:00 ~ 23:59,11,11,0,52,1286640,52,20230618,21-24,저녁
합계,4767,4767,23376,26153,1635726230,49529,20230618,,
00:00 ~ 2:59,0,0,0,0,0,0,20230619,0-3,심야
3:00 ~ 5:59,0,0,0,0,0,0,20230619,3-6,심야
6:00 ~ 8:59,0,0,0,0,0,0,20230619,6-9,심야
9:00 ~ 11:59,569,569,1359,3298,74524140,4657,20230619,9-12,주간
12:00 ~ 14:59,1048,1048,4760,10539,573458945,15299,20230619,12-15,주간
15:00 ~ 17:59,1298,1298,6280,13278,990472510,19558,20230619,15-18,주간
18:00 ~ 20:59,2184,2184,21249,29404,1768348460,50653,20230619,18-21,저녁
21:00 ~ 23:59,8,8,5,16,367280,21,20230619,21-24,저녁
합계,5107,5107,33653,56535,3407171335,90188,20230619,,
00:00 ~ 2:59,0,0,0,0,0,0,20230620,0-3,심야
3:00 ~ 5:59,1,1,0,2,0,2,20230620,3-6,심야
6:00 ~ 8:59,0,0,0,0,0,0,20230620,6-9,심야
9:00 ~ 11:59,670,670,1558,5321,143566250,6879,20230620,9-12,주간
12:00 ~ 14:59,1108,1108,6620,7977,435865272,14597,20230620,12-15,주간
15:00 ~ 17:59,1364,1364,5652,8670,315437400,14322,20230620,15-18,주간
18:00 ~ 20:59,2189,2189,24839,22080,1472559262,46919,20230620,18-21,저녁
21:00 ~ 23:59,13,13,18,24,735700,42,20230620,21-24,저녁
합계,5345,5345,38687,44074,2368163884,82761,20230620,,
00:00 ~ 2:59,0,0,0,0,0,0,20230621,0-3,심야
3:00 ~ 5:59,0,0,0,0,0,0,20230621,3-6,심야
6:00 ~ 8:59,0,0,0,0,0,0,20230621,6-9,심야
9:00 ~ 11:59,617,617,1878,3901,83798480,5779,20230621,9-12,주간
12:00 ~ 14:59,1157,1157,5707,7772,562518990,13479,20230621,12-15,주간
15:00 ~ 17:59,1376,1376,4650,11440,408042610,16090,20230621,15-18,주간
18:00 ~ 20:59,2204,2204,20900,23700,1110198228,44600,20230621,18-21,저녁
21:00 ~ 23:59,14,14,9,47,877920,56,20230621,21-24,저녁
합계,5368,5368,33144,46860,2165436228,80004,20230621,,
00:00 ~ 2:59,0,0,0,0,0,0,20230622,0-3,심야
3:00 ~ 5:59,1,1,0,6,107400,6,20230622,3-6,심야
6:00 ~ 8:59,0,0,0,0,0,0,20230622,6-9,심야
9:00 ~ 11:59,658,658,2273,4402,86365130,6675,20230622,9-12,주간
12:00 ~ 14:59,1176,1176,9897,9724,439292691,19621,20230622,12-15,주간
15:00 ~ 17:59,1444,1444,6171,13142,589824285,19313,20230622,15-18,주간
18:00 ~ 20:59,2311,2311,20925,32222,1379247610,53147,20230622,18-21,저녁
21:00 ~ 23:59,12,12,51,357,14244960,408,20230622,21-24,저녁
합계,5602,5602,39317,59853,2509082076,99170,20230622,,
00:00 ~ 2:59,0,0,0,0,0,0,20230623,0-3,심야
3:00 ~ 5:59,0,0,0,0,0,0,20230623,3-6,심야
6:00 ~ 8:59,0,0,0,0,0,0,20230623,6-9,심야
9:00 ~ 11:59,703,703,2379,8357,90317420,10736,20230623,9-12,주간
12:00 ~ 14:59,1320,1320,5357,17794,471818579,23151,20230623,12-15,주간
15:00 ~ 17:59,1553,1553,5476,15667,382826481,21143,20230623,15-18,주간
18:00 ~ 20:59,2244,2244,17514,27251,1232792720,44765,20230623,18-21,저녁
21:00 ~ 23:59,18,18,48,290,18331700,338,20230623,21-24,저녁
합계,5838,5838,30774,69359,2196086900,100133,20230623,,
00:00 ~ 2:59,0,0,0,0,0,0,20230624,0-3,심야
3:00 ~ 5:59,0,0,0,0,0,0,20230624,3-6,심야
6:00 ~ 8:59,0,0,0,0,0,0,20230624,6-9,심야
9:00 ~ 11:59,632,632,1387,3216,83347920,4603,20230624,9-12,주간
12:00 ~ 14:59,1191,1191,6189,5853,385746250,12042,20230624,12-15,주간
15:00 ~ 17:59,1448,1448,4866,10418,341464640,15284,20230624,15-18,주간
18:00 ~ 20:59,1983,1983,11933,11480,852685970,23413,20230624,18-21,저녁
21:00 ~ 23:59,20,20,35,132,5527440,167,20230624,21-24,저녁
합계,5274,5274,24410,31099,1668772220,55509,20230624,,
00:00 ~ 2:59,0,0,0,0,0,0,20230625,0-3,심야
3:00 ~ 5:59,2,2,0,4,71600,4,20230625,3-6,심야
6:00 ~ 8:59,0,0,0,0,0,0,20230625,6-9,심야
9:00 ~ 11:59,572,572,1107,2475,80531470,3582,20230625,9-12,주간
12:00 ~ 14:59,1128,1128,4676,7036,363763740,11712,20230625,12-15,주간
15:00 ~ 17:59,1266,1266,3492,8839,287945930,12331,20230625,15-18,주간
18:00 ~ 20:59,1920,1920,10023,11725,722992410,21748,20230625,18-21,저녁
21:00 ~ 23:59,18,18,29,85,3838900,114,20230625,21-24,저녁
합계,4906,4906,19327,30164,1459144050,49491,20230625,,
00:00 ~ 2:59,0,0,0,0,0,0,20230626,0-3,심야
3:00 ~ 5:59,5,5,2,202,35800,204,20230626,3-6,심야
6:00 ~ 8:59,0,0,0,0,0,0,20230626,6-9,심야
9:00 ~ 11:59,624,624,1763,5539,86157470,7302,20230626,9-12,주간
12:00 ~ 14:59,1131,1131,4354,7984,361196330,12338,20230626,12-15,주간
15:00 ~ 17:59,1390,1390,4012,8456,297475580,12468,20230626,15-18,주간
18:00 ~ 20:59,2134,2134,15070,17478,842530970,32548,20230626,18-21,저녁
21:00 ~ 23:59,21,21,32,78,2806550,110,20230626,21-24,저녁
합계,5305,5305,25233,39737,1590202700,64970,20230626,,
00:00 ~ 2:59,0,0,0,0,0,0,20230627,0-3,심야
3:00 ~ 5:59,10,10,12,348,71600,360,20230627,3-6,심야
6:00 ~ 8:59,0,0,0,0,0,0,20230627,6-9,심야
9:00 ~ 11:59,643,643,1819,5143,143958470,6962,20230627,9-12,주간
12:00 ~ 14:59,1116,1116,5531,13225,1111531280,18756,20230627,12-15,주간
15:00 ~ 17:59,1386,1386,5516,15542,970111860,21058,20230627,15-18,주간
18:00 ~ 20:59,2197,2197,16815,32810,2087507900,49625,20230627,18-21,저녁
21:00 ~ 23:59,19,19,38,28,1292880,66,20230627,21-24,저녁
합계,5371,5371,29731,67096,4314473990,96827,20230627,,
00:00 ~ 2:59,0,0,0,0,0,0,20230628,0-3,심야
3:00 ~ 5:59,11,11,0,750,107400,750,20230628,3-6,심야
6:00 ~ 8:59,0,0,0,0,0,0,20230628,6-9,심야
9:00 ~ 11:59,672,672,1741,4999,92505490,6740,20230628,9-12,주간
12:00 ~ 14:59,1199,1199,4451,10980,607928092,15431,20230628,12-15,주간
15:00 ~ 17:59,1426,1426,4928,12347,483339100,17275,20230628,15-18,주간
18:00 ~ 20:59,2287,2287,14906,37738,3315898510,52644,20230628,18-21,저녁
21:00 ~ 23:59,18,18,23,35,584930,58,20230628,21-24,저녁
합계,5613,5613,26049,66849,4500363522,92898,20230628,,
00:00 ~ 2:59,0,0,0,0,0,0,20230629,0-3,심야
3:00 ~ 5:59,12,12,12,646,179000,658,20230629,3-6,심야
6:00 ~ 8:59,0,0,0,0,0,0,20230629,6-9,심야
9:00 ~ 11:59,667,667,1846,4041,88359586,5887,20230629,9-12,주간
12:00 ~ 14:59,1208,1208,5210,9075,546193640,14285,20230629,12-15,주간
15:00 ~ 17:59,1490,1490,5596,9950,417080764,15546,20230629,15-18,주간
18:00 ~ 20:59,2191,2191,16598,33787,2967682420,50385,20230629,18-21,저녁
21:00 ~ 23:59,20,20,62,26,952640,88,20230629,21-24,저녁
합계,5588,5588,29324,57525,4020448050,86849,20230629,,
00:00 ~ 2:59,0,0,0,0,0,0,20230630,0-3,심야
3:00 ~ 5:59,3,3,6,6,107400,12,20230630,3-6,심야
6:00 ~ 8:59,0,0,0,0,0,0,20230630,6-9,심야
9:00 ~ 11:59,681,681,2586,4407,108375830,6993,20230630,9-12,주간
12:00 ~ 14:59,1264,1264,5333,12293,617053770,17626,20230630,12-15,주간
15:00 ~ 17:59,1568,1568,5319,13510,549329430,18829,20230630,15-18,주간
18:00 ~ 20:59,2221,2221,14361,30792,2034246680,45153,20230630,18-21,저녁
21:00 ~ 23:59,17,17,51,60,1407000,111,20230630,21-24,저녁
합계,5754,5754,27656,61068,3310520110,88724,20230630,,
00:00 ~ 2:59,0,0,0,0,0,0,20230701,0-3,심야
3:00 ~ 5:59,1,1,0,2,35800,2,20230701,3-6,심야
6:00 ~ 8:59,0,0,0,0,0,0,20230701,6-9,심야
9:00 ~ 11:59,686,686,2123,2879,101385080,5002,20230701,9-12,주간
12:00 ~ 14:59,1304,1304,5177,9779,526677610,14956,20230701,12-15,주간
15:00 ~ 17:59,1551,1551,5551,9703,376667310,15254,20230701,15-18,주간
18:00 ~ 20:59,2035,2035,11537,17183,1377396581,28720,20230701,18-21,저녁
21:00 ~ 23:59,17,17,16,60,1513320,76,20230701,21-24,저녁
합계,5594,5594,24404,39606,2383675701,64010,20230701,,
00:00 ~ 2:59,0,0,0,0,0,0,20230702,0-3,심야
3:00 ~ 5:59,0,0,0,0,0,0,20230702,3-6,심야
6:00 ~ 8:59,0,0,0,0,0,0,20230702,6-9,심야
9:00 ~ 11:59,684,684,2050,2941,100219538,4991,20230702,9-12,주간
12:00 ~ 14:59,1258,1258,5379,7492,437811434,12871,20230702,12-15,주간
15:00 ~ 17:59,1409,1409,4077,8820,355371641,12897,20230702,15-18,주간
18:00 ~ 20:59,1913,1913,8605,11894,800296987,20499,20230702,18-21,저녁
21:00 ~ 23:59,18,18,25,17,424050,42,20230702,21-24,저녁
합계,5282,5282,20136,31164,1694123650,51300,20230702,,
00:00 ~ 2:59,0,0,0,0,0,0,20230703,0-3,심야
3:00 ~ 5:59,0,0,0,0,0,0,20230703,3-6,심야
6:00 ~ 8:59,0,0,0,0,0,0,20230703,6-9,심야
9:00 ~ 11:59,761,761,1642,3652,93467250,5294,20230703,9-12,주간
12:00 ~ 14:59,1282,1282,4786,7879,452815256,12665,20230703,12-15,주간
15:00 ~ 17:59,1461,1461,4186,9315,409099386,13501,20230703,15-18,주간
18:00 ~ 20:59,2057,2057,13713,18906,1136205404,32619,20230703,18-21,저녁
21:00 ~ 23:59,18,18,35,25,842210,60,20230703,21-24,저녁
합계,5579,5579,24362,39777,2092429506,64139,20230703,,
00:00 ~ 2:59,0,0,0,0,0,0,20230704,0-3,심야
3:00 ~ 5:59,0,0,0,0,0,0,20230704,3-6,심야
6:00 ~ 8:59,0,0,0,0,0,0,20230704,6-9,심야
9:00 ~ 11:59,772,772,1998,5001,137123900,6999,20230704,9-12,주간
12:00 ~ 14:59,1314,1314,5115,12637,742790404,17752,20230704,12-15,주간
15:00 ~ 17:59,1513,1513,5202,15204,749409340,20406,20230704,15-18,주간
18:00 ~ 20:59,2109,2109,17812,29757,1657035030,47569,20230704,18-21,저녁
21:00 ~ 23:59,20,20,19,45,412940,64,20230704,21-24,저녁
합계,5728,5728,30146,62644,3286771614,92790,20230704,,
00:00 ~ 2:59,0,0,0,0,0,0,20230705,0-3,심야
3:00 ~ 5:59,0,0,0,0,0,0,20230705,3-6,심야
6:00 ~ 8:59,0,0,0,0,0,0,20230705,6-9,심야
9:00 ~ 11:59,761,761,3192,4746,92375800,7938,20230705,9-12,주간
12:00 ~ 14:59,1345,1345,5491,10877,612923360,16368,20230705,12-15,주간
15:00 ~ 17:59,1575,1575,7079,14613,618334560,21692,20230705,15-18,주간
18:00 ~ 20:59,2181,2181,19158,46935,4013903920,66093,20230705,18-21,저녁
21:00 ~ 23:59,17,17,27,83,409300,110,20230705,21-24,저녁
합계,5879,5879,34947,77254,5337946940,112201,20230705,,
00:00 ~ 2:59,0,0,0,0,0,0,20230706,0-3,심야
3:00 ~ 5:59,0,0,0,0,0,0,20230706,3-6,심야
6:00 ~ 8:59,0,0,0,0,0,0,20230706,6-9,심야
9:00 ~ 11:59,750,750,2897,5257,110577600,8154,20230706,9-12,주간
12:00 ~ 14:59,1344,1344,5083,12668,517311780,17751,20230706,12-15,주간
15:00 ~ 17:59,1547,1547,6021,18968,971576680,24989,20230706,15-18,주간
18:00 ~ 20:59,2184,2184,18203,31176,1743524630,49379,20230706,18-21,저녁
21:00 ~ 23:59,18,18,22,65,1667610,87,20230706,21-24,저녁
합계,5843,5843,32226,68134,3344658300,100360,20230706,,
00:00 ~ 2:59,0,0,0,0,0,0,20230707,0-3,심야
3:00 ~ 5:59,0,0,0,0,0,0,20230707,3-6,심야
6:00 ~ 8:59,0,0,0,0,0,0,20230707,6-9,심야
9:00 ~ 11:59,763,763,2076,5912,126831258,7988,20230707,9-12,주간
12:00 ~ 14:59,1438,1438,5833,15052,707869150,20885,20230707,12-15,주간
15:00 ~ 17:59,1611,1611,6678,15102,611244272,21780,20230707,15-18,주간
18:00 ~ 20:59,2198,2198,17449,28339,1451587680,45788,20230707,18-21,저녁
21:00 ~ 23:59,19,19,17,54,733780,71,20230707,21-24,저녁
합계,6029,6029,32053,64459,2898266140,96512,20230707,,
00:00 ~ 2:59,0,0,0,0,0,0,20230708,0-3,심야
3:00 ~ 5:59,0,0,0,0,0,0,20230708,3-6,심야
6:00 ~ 8:59,0,0,0,0,0,0,20230708,6-9,심야
9:00 ~ 11:59,704,704,3022,4140,100223440,7162,20230708,9-12,주간
12:00 ~ 14:59,1347,1347,6250,9089,507372070,15339,20230708,12-15,주간
15:00 ~ 17:59,1521,1521,5827,11917,437243900,17744,20230708,15-18,주간
18:00 ~ 20:59,1928,1928,9317,13906,925262120,23223,20230708,18-21,저녁
21:00 ~ 23:59,15,15,6,63,1331100,69,20230708,21-24,저녁
합계,5515,5515,24422,39115,1971432630,63537,20230708,,
00:00 ~ 2:59,0,0,0,0,0,0,20230709,0-3,심야
3:00 ~ 5:59,0,0,0,0,0,0,20230709,3-6,심야
6:00 ~ 8:59,0,0,0,0,0,0,20230709,6-9,심야
9:00 ~ 11:59,693,693,1862,2746,84365570,4608,20230709,9-12,주간
12:00 ~ 14:59,1278,1278,5779,8082,409952931,13861,20230709,12-15,주간
15:00 ~ 17:59,1428,1428,4056,8663,371008702,12719,20230709,15-18,주간
18:00 ~ 20:59,1865,1865,7927,12177,746921330,20104,20230709,18-21,저녁
21:00 ~ 23:59,17,17,8,37,794950,45,20230709,21-24,저녁
합계,5281,5281,19632,31705,1613043483,51337,20230709,,
00:00 ~ 2:59,0,0,0,0,0,0,20230710,0-3,심야
3:00 ~ 5:59,0,0,0,0,0,0,20230710,3-6,심야
6:00 ~ 8:59,0,0,0,0,0,0,20230710,6-9,심야
9:00 ~ 11:59,778,778,1684,4201,90922130,5885,20230710,9-12,주간
12:00 ~ 14:59,1327,1327,4955,10641,639703740,15596,20230710,12-15,주간
15:00 ~ 17:59,1482,1482,6058,13987,894813660,20045,20230710,15-18,주간
18:00 ~ 20:59,2156,2156,20973,25200,1673195282,46173,20230710,18-21,저녁
21:00 ~ 23:59,21,21,42,48,1397890,90,20230710,21-24,저녁
합계,5764,5764,33712,54077,3300032702,87789,20230710,,
00:00 ~ 2:59,0,0,0,0,0,0,20230711,0-3,심야
3:00 ~ 5:59,0,0,0,0,0,0,20230711,3-6,심야
6:00 ~ 8:59,0,0,0,0,0,0,20230711,6-9,심야
9:00 ~ 11:59,736,736,1987,2799,85594360,4786,20230711,9-12,주간
12:00 ~ 14:59,1331,1331,7531,10429,703154002,17960,20230711,12-15,주간
15:00 ~ 17:59,1482,1482,5992,12903,648498622,18895,20230711,15-18,주간
18:00 ~ 20:59,2171,2171,24281,29025,2254105962,53306,20230711,18-21,저녁
21:00 ~ 23:59,18,18,9,31,924880,40,20230711,21-24,저녁
합계,5738,5738,39800,55187,3692277826,94987,20230711,,
00:00 ~ 2:59,0,0,0,0,0,0,20230712,0-3,심야
3:00 ~ 5:59,0,0,0,0,0,0,20230712,3-6,심야
6:00 ~ 8:59,0,0,0,0,0,0,20230712,6-9,심야
9:00 ~ 11:59,836,836,2749,5186,118753440,7935,20230712,9-12,주간
12:00 ~ 14:59,1497,1497,7400,14792,1037356082,22192,20230712,12-15,주간
15:00 ~ 17:59,1590,1590,6527,19711,1536305960,26238,20230712,15-18,주간
18:00 ~ 20:59,2226,2226,19407,35739,2648738634,55146,20230712,18-21,저녁
21:00 ~ 23:59,18,18,33,23,517350,56,20230712,21-24,저녁
합계,6167,6167,36116,75451,5341671466,111567,20230712,,
00:00 ~ 2:59,0,0,0,0,0,0,20230713,0-3,심야
3:00 ~ 5:59,0,0,0,0,0,0,20230713,3-6,심야
6:00 ~ 8:59,0,0,0,0,0,0,20230713,6-9,심야
9:00 ~ 11:59,802,802,3041,5826,115782460,8867,20230713,9-12,주간
12:00 ~ 14:59,1429,1429,6618,10126,490450547,16744,20230713,12-15,주간
15:00 ~ 17:59,1645,1645,5641,10708,399395730,16349,20230713,15-18,주간
18:00 ~ 20:59,2228,2228,17806,23178,1095482746,40984,20230713,18-21,저녁
21:00 ~ 23:59,17,17,53,416,30047740,469,20230713,21-24,저녁
합계,6121,6121,33159,50254,2131159223,83413,20230713,,
00:00 ~ 2:59,0,0,0,0,0,0,20230714,0-3,심야
3:00 ~ 5:59,0,0,0,0,0,0,20230714,3-6,심야
6:00 ~ 8:59,0,0,0,0,0,0,20230714,6-9,심야
9:00 ~ 11:59,851,851,2922,6273,118386850,9195,20230714,9-12,주간
12:00 ~ 14:59,1530,1530,7759,13332,476812852,21091,20230714,12-15,주간
15:00 ~ 17:59,1736,1736,6247,14105,430885180,20352,20230714,15-18,주간
18:00 ~ 20:59,2294,2294,15468,27334,1064174910,42802,20230714,18-21,저녁
21:00 ~ 23:59,19,19,35,175,11476500,210,20230714,21-24,저녁
합계,6430,6430,32431,61219,2101736292,93650,20230714,,
00:00 ~ 2:59,0,0,0,0,0,0,20230715,0-3,심야
3:00 ~ 5:59,0,0,0,0,0,0,20230715,3-6,심야
6:00 ~ 8:59,0,0,0,0,0,0,20230715,6-9,심야
9:00 ~ 11:59,828,828,3096,4001,93692730,7097,20230715,9-12,주간
12:00 ~ 14:59,1497,1497,7419,10181,421328730,17600,20230715,12-15,주간
15:00 ~ 17:59,1630,1630,6481,11898,373838970,18379,20230715,15-18,주간
18:00 ~ 20:59,2015,2015,23329,715,698090330,24044,20230715,18-21,저녁
21:00 ~ 23:59,15,15,99,91,5020000,190,20230715,21-24,저녁
합계,5985,5985,40424,26886,1591970760,67310,20230715,,
00:00 ~ 2:59,0,0,0,0,0,0,20230716,0-3,심야
3:00 ~ 5:59,0,0,0,0,0,0,20230716,3-6,심야
6:00 ~ 8:59,0,0,0,0,0,0,20230716,6-9,심야
9:00 ~ 11:59,783,783,1795,4041,79926710,5836,20230716,9-12,주간
12:00 ~ 14:59,1420,1420,5372,8221,376299970,13593,20230716,12-15,주간
15:00 ~ 17:59,1551,1551,5356,7973,324432861,13329,20230716,15-18,주간
18:00 ~ 20:59,1932,1932,8771,10948,630755110,19719,20230716,18-21,저녁
21:00 ~ 23:59,18,18,66,58,3088200,124,20230716,21-24,저녁
합계,5704,5704,21360,31241,1414502851,52601,20230716,,
00:00 ~ 2:59,0,0,0,0,0,0,20230717,0-3,심야
3:00 ~ 5:59,0,0,0,0,0,0,20230717,3-6,심야
6:00 ~ 8:59,0,0,0,0,0,0,20230717,6-9,심야
9:00 ~ 11:59,821,821,2141,3882,102230010,6023,20230717,9-12,주간
12:00 ~ 14:59,1403,1403,5133,8585,418408050,13718,20230717,12-15,주간
15:00 ~ 17:59,1573,1573,5376,10731,365534990,16107,20230717,15-18,주간
18:00 ~ 20:59,2193,2193,13758,20758,845115941,34516,20230717,18-21,저녁
21:00 ~ 23:59,21,21,42,67,2060640,109,20230717,21-24,저녁
합계,6011,6011,26450,44023,1733349631,70473,20230717,,
00:00 ~ 2:59,0,0,0,0,0,0,20230718,0-3,심야
3:00 ~ 5:59,0,0,0,0,0,0,20230718,3-6,심야
6:00 ~ 8:59,0,0,0,0,0,0,20230718,6-9,심야
9:00 ~ 11:59,891,891,2840,5162,120018900,8002,20230718,9-12,주간
12:00 ~ 14:59,1470,1470,6112,9244,503907131,15356,20230718,12-15,주간
15:00 ~ 17:59,1596,1596,6450,18839,1315346001,25289,20230718,15-18,주간
18:00 ~ 20:59,2269,2269,17458,27715,1727171380,45173,20230718,18-21,저녁
21:00 ~ 23:59,23,23,37,61,1668160,98,20230718,21-24,저녁
합계,6249,6249,32897,61021,3668111572,93918,20230718,,
00:00 ~ 2:59,0,0,0,0,0,0,20230719,0-3,심야
3:00 ~ 5:59,0,0,0,0,0,0,20230719,3-6,심야
6:00 ~ 8:59,0,0,0,0,0,0,20230719,6-9,심야
9:00 ~ 11:59,857,857,3340,4953,189879550,8293,20230719,9-12,주간
12:00 ~ 14:59,1497,1497,5559,11776,601435600,17335,20230719,12-15,주간
15:00 ~ 17:59,1666,1666,7895,16327,1039864540,24222,20230719,15-18,주간
18:00 ~ 20:59,2264,2264,18376,49531,4811352572,67907,20230719,18-21,저녁
21:00 ~ 23:59,20,20,24,87,1781900,111,20230719,21-24,저녁
합계,6304,6304,35194,82674,6644314162,117868,20230719,,
00:00 ~ 2:59,0,0,0,0,0,0,20230720,0-3,심야
3:00 ~ 5:59,0,0,0,0,0,0,20230720,3-6,심야
6:00 ~ 8:59,0,0,0,0,0,0,20230720,6-9,심야
9:00 ~ 11:59,909,909,3503,5721,126845170,9224,20230720,9-12,주간
12:00 ~ 14:59,1529,1529,6434,12706,786757102,19140,20230720,12-15,주간
15:00 ~ 17:59,1696,1696,8142,23922,2470912670,32064,20230720,15-18,주간
18:00 ~ 20:59,2277,2277,19109,52338,6021486850,71447,20230720,18-21,저녁
21:00 ~ 23:59,14,14,36,58,706740,94,20230720,21-24,저녁
합계,6425,6425,37224,94745,9406708532,131969,20230720,,
00:00 ~ 2:59,0,0,0,0,0,0,20230721,0-3,심야
3:00 ~ 5:59,0,0,0,0,0,0,20230721,3-6,심야
6:00 ~ 8:59,0,0,0,0,0,0,20230721,6-9,심야
9:00 ~ 11:59,918,918,4426,4498,109405060,8924,20230721,9-12,주간
12:00 ~ 14:59,1565,1565,6851,13335,606676091,20186,20230721,12-15,주간
15:00 ~ 17:59,1712,1712,9582,15782,1064658320,25364,20230721,15-18,주간
18:00 ~ 20:59,2234,2234,17879,31065,2473050260,48944,20230721,18-21,저녁
21:00 ~ 23:59,13,13,20,93,999900,113,20230721,21-24,저녁
합계,6442,6442,38758,64773,4254789631,103531,20230721,,
00:00 ~ 2:59,0,0,0,0,0,0,20230722,0-3,심야
3:00 ~ 5:59,0,0,0,0,0,0,20230722,3-6,심야
6:00 ~ 8:59,0,0,0,0,0,0,20230722,6-9,심야
9:00 ~ 11:59,845,845,2789,3826,98536890,6615,20230722,9-12,주간
12:00 ~ 14:59,1537,1537,8333,10899,498251340,19232,20230722,12-15,주간
15:00 ~ 17:59,1600,1600,9381,8509,392734371,17890,20230722,15-18,주간
18:00 ~ 20:59,1990,1990,14119,14855,1030491780,28974,20230722,18-21,저녁
21:00 ~ 23:59,10,10,9,103,1287800,112,20230722,21-24,저녁
합계,5982,5982,34631,38192,2021302181,72823,20230722,,
00:00 ~ 2:59,0,0,0,0,0,0,20230723,0-3,심야
3:00 ~ 5:59,0,0,0,0,0,0,20230723,3-6,심야
6:00 ~ 8:59,0,0,0,0,0,0,20230723,6-9,심야
9:00 ~ 11:59,824,824,2486,3391,76797790,5877,20230723,9-12,주간
12:00 ~ 14:59,1416,1416,6431,8565,435295530,14996,20230723,12-15,주간
15:00 ~ 17:59,1546,1546,6303,7847,321166021,14150,20230723,15-18,주간
18:00 ~ 20:59,1871,1871,9497,11901,699764870,21398,20230723,18-21,저녁
21:00 ~ 23:59,12,12,7,33,407650,40,20230723,21-24,저녁
합계,5669,5669,24724,31737,1533431861,56461,20230723,,
00:00 ~ 2:59,0,0,0,0,0,0,20230724,0-3,심야
3:00 ~ 5:59,0,0,0,0,0,0,20230724,3-6,심야
6:00 ~ 8:59,0,0,0,0,0,0,20230724,6-9,심야
9:00 ~ 11:59,916,916,2545,4944,100000650,7489,20230724,9-12,주간
12:00 ~ 14:59,1499,1499,5836,10084,484516011,15920,20230724,12-15,주간
15:00 ~ 17:59,1580,1580,7121,11720,469273921,18841,20230724,15-18,주간
18:00 ~ 20:59,2102,2102,14311,30205,2310773910,44516,20230724,18-21,저녁
21:00 ~ 23:59,9,9,13,22,345100,35,20230724,21-24,저녁
합계,6106,6106,29826,56975,3364909592,86801,20230724,,
00:00 ~ 2:59,1,1,2,-2,-31800,0,20230725,0-3,심야
3:00 ~ 5:59,4,4,0,200,0,200,20230725,3-6,심야
6:00 ~ 8:59,0,0,0,0,0,0,20230725,6-9,심야
9:00 ~ 11:59,988,988,4639,7456,127220840,12095,20230725,9-12,주간
12:00 ~ 14:59,1593,1593,7550,12655,701902261,20205,20230725,12-15,주간
15:00 ~ 17:59,1696,1696,6797,14739,628816470,21536,20230725,15-18,주간
18:00 ~ 20:59,2225,2225,19578,29581,1881650030,49159,20230725,18-21,저녁
21:00 ~ 23:59,13,13,16,45,572280,61,20230725,21-24,저녁
합계,6520,6520,38582,64674,3340130081,103256,20230725,,
00:00 ~ 2:59,1,1,0,2,31800,2,20230726,0-3,심야
3:00 ~ 5:59,0,0,0,0,0,0,20230726,3-6,심야
6:00 ~ 8:59,0,0,0,0,0,0,20230726,6-9,심야
9:00 ~ 11:59,944,944,4002,6159,142918430,10161,20230726,9-12,주간
12:00 ~ 14:59,1635,1635,7298,12650,646692687,19948,20230726,12-15,주간
15:00 ~ 17:59,1716,1716,6415,13887,494203911,20302,20230726,15-18,주간
18:00 ~ 20:59,2217,2217,22516,43430,3260022680,65946,20230726,18-21,저녁
21:00 ~ 23:59,13,13,17,70,969780,87,20230726,21-24,저녁
합계,6526,6526,40248,76198,4544839288,116446,20230726,,
00:00 ~ 2:59,1,1,4,-2,-31800,2,20230727,0-3,심야
3:00 ~ 5:59,0,0,0,0,0,0,20230727,3-6,심야
6:00 ~ 8:59,0,0,0,0,0,0,20230727,6-9,심야
9:00 ~ 11:59,877,877,4118,5412,101995920,9530,20230727,9-12,주간
12:00 ~ 14:59,1566,1566,9057,39325,3304487478,48382,20230727,12-15,주간
15:00 ~ 17:59,1726,1726,6024,12623,549557952,18647,20230727,15-18,주간
18:00 ~ 20:59,2223,2223,19639,32165,2277128810,51804,20230727,18-21,저녁
21:00 ~ 23:59,13,13,41,41,822360,82,20230727,21-24,저녁
합계,6406,6406,38883,89564,6233960720,128447,20230727,,
00:00 ~ 2:59,0,0,0,0,0,0,20230728,0-3,심야
3:00 ~ 5:59,0,0,0,0,0,0,20230728,3-6,심야
6:00 ~ 8:59,0,0,0,0,0,0,20230728,6-9,심야
9:00 ~ 11:59,861,861,3669,5354,99164840,9023,20230728,9-12,주간
12:00 ~ 14:59,1598,1598,8935,19217,1102625988,28152,20230728,12-15,주간
15:00 ~ 17:59,1791,1791,6361,20004,926730168,26365,20230728,15-18,주간
18:00 ~ 20:59,2195,2195,17910,27191,2030289245,45101,20230728,18-21,저녁
21:00 ~ 23:59,8,8,9,85,1015230,94,20230728,21-24,저녁
합계,6453,6453,36884,71851,4159825471,108735,20230728,,
00:00 ~ 2:59,0,0,0,0,0,0,20230729,0-3,심야
3:00 ~ 5:59,0,0,0,0,0,0,20230729,3-6,심야
6:00 ~ 8:59,0,0,0,0,0,0,20230729,6-9,심야
9:00 ~ 11:59,813,813,3179,4506,112366770,7685,20230729,9-12,주간
12:00 ~ 14:59,1511,1511,9501,12673,655783150,22174,20230729,12-15,주간
15:00 ~ 17:59,1613,1613,7030,13250,525759450,20280,20230729,15-18,주간
18:00 ~ 20:59,1991,1991,13219,13554,803465350,26773,20230729,18-21,저녁
21:00 ~ 23:59,5,5,6,35,783280,41,20230729,21-24,저녁
합계,5933,5933,32935,44018,2098158000,76953,20230729,,
00:00 ~ 2:59,0,0,0,0,0,0,20230730,0-3,심야
3:00 ~ 5:59,0,0,0,0,0,0,20230730,3-6,심야
6:00 ~ 8:59,0,0,0,0,0,0,20230730,6-9,심야
9:00 ~ 11:59,716,716,2995,3365,100688740,6360,20230730,9-12,주간
12:00 ~ 14:59,1380,1380,8563,8809,525835920,17372,20230730,12-15,주간
15:00 ~ 17:59,1504,1504,5868,9070,353247850,14938,20230730,15-18,주간
18:00 ~ 20:59,1879,1879,9501,12284,851387342,21785,20230730,18-21,저녁
21:00 ~ 23:59,6,6,3,36,553640,39,20230730,21-24,저녁
합계,5485,5485,26930,33564,1831713492,60494,20230730,,
00:00 ~ 2:59,0,0,0,0,0,0,20230731,0-3,심야
3:00 ~ 5:59,0,0,0,0,0,0,20230731,3-6,심야
6:00 ~ 8:59,0,0,0,0,0,0,20230731,6-9,심야
9:00 ~ 11:59,774,774,2322,4957,110842440,7279,20230731,9-12,주간
12:00 ~ 14:59,1384,1384,5897,10720,481770802,16617,20230731,12-15,주간
15:00 ~ 17:59,1557,1557,5281,9984,389194230,15265,20230731,15-18,주간
18:00 ~ 20:59,2125,2125,16637,16732,784948867,33369,20230731,18-21,저녁
21:00 ~ 23:59,7,7,6,26,179100,32,20230731,21-24,저녁
합계,5847,5847,30143,42419,1766935439,72562,20230731,,
00:00 ~ 2:59,0,0,0,0,0,0,20230801,0-3,심야
3:00 ~ 5:59,8,8,0,498,0,498,20230801,3-6,심야
6:00 ~ 8:59,0,0,0,0,0,0,20230801,6-9,심야
9:00 ~ 11:59,832,832,3993,5844,124211430,9837,20230801,9-12,주간
12:00 ~ 14:59,1566,1566,9025,13581,586214254,22606,20230801,12-15,주간
15:00 ~ 17:59,1750,1750,6732,14738,480650970,21470,20230801,15-18,주간
18:00 ~ 20:59,2353,2353,18604,25426,1345328979,44030,20230801,18-21,저녁
21:00 ~ 23:59,9,9,5,30,360860,35,20230801,21-24,저녁
합계,6518,6518,38359,60117,2536766493,98476,20230801,,
00:00 ~ 2:59,0,0,0,0,0,0,20230802,0-3,심야
3:00 ~ 5:59,8,8,8,1028,0,1036,20230802,3-6,심야
6:00 ~ 8:59,0,0,0,0,0,0,20230802,6-9,심야
9:00 ~ 11:59,830,830,5460,5923,145072370,11383,20230802,9-12,주간
12:00 ~ 14:59,1530,1530,9283,14891,597311563,24174,20230802,12-15,주간
15:00 ~ 17:59,1737,1737,7301,13651,508459810,20952,20230802,15-18,주간
18:00 ~ 20:59,2282,2282,20407,26846,1320315826,47253,20230802,18-21,저녁
21:00 ~ 23:59,7,7,0,29,391480,29,20230802,21-24,저녁
합계,6394,6394,42459,62368,2571551049,104827,20230802,,
00:00 ~ 2:59,0,0,0,0,0,0,20230803,0-3,심야
3:00 ~ 5:59,7,7,0,428,0,428,20230803,3-6,심야
6:00 ~ 8:59,0,0,0,0,0,0,20230803,6-9,심야
9:00 ~ 11:59,796,796,4298,6790,144448620,11088,20230803,9-12,주간
12:00 ~ 14:59,1502,1502,8218,12883,450826800,21101,20230803,12-15,주간
15:00 ~ 17:59,1748,1748,6411,15226,591686150,21637,20230803,15-18,주간
18:00 ~ 20:59,2218,2218,18921,25978,1499672339,44899,20230803,18-21,저녁
21:00 ~ 23:59,8,8,3,58,970330,61,20230803,21-24,저녁
합계,6279,6279,37851,61363,2687604239,99214,20230803,,
00:00 ~ 2:59,0,0,0,0,0,0,20230804,0-3,심야
3:00 ~ 5:59,0,0,0,0,0,0,20230804,3-6,심야
6:00 ~ 8:59,0,0,0,0,0,0,20230804,6-9,심야
9:00 ~ 11:59,761,761,3667,7428,160832590,11095,20230804,9-12,주간
12:00 ~ 14:59,1494,1494,8478,11776,486115040,20254,20230804,12-15,주간
15:00 ~ 17:59,1707,1707,6956,22686,1315671720,29642,20230804,15-18,주간
18:00 ~ 20:59,2147,2147,20358,47775,4490260125,68133,20230804,18-21,저녁
21:00 ~ 23:59,5,5,9,35,431600,44,20230804,21-24,저녁
합계,6114,6114,39468,89700,6453311075,129168,20230804,,
00:00 ~ 2:59,0,0,0,0,0,0,20230805,0-3,심야
3:00 ~ 5:59,0,0,0,0,0,0,20230805,3-6,심야
6:00 ~ 8:59,0,0,0,0,0,0,20230805,6-9,심야
9:00 ~ 11:59,735,735,3206,5072,134245520,8278,20230805,9-12,주간
12:00 ~ 14:59,1342,1342,7566,11036,411697218,18602,20230805,12-15,주간
15:00 ~ 17:59,1568,1568,6566,13271,482218901,19837,20230805,15-18,주간
18:00 ~ 20:59,1893,1893,11167,17467,1486945664,28634,20230805,18-21,저녁
21:00 ~ 23:59,7,7,12,51,888700,63,20230805,21-24,저녁
합계,5545,5545,28517,46897,2515996003,75414,20230805,,
00:00 ~ 2:59,0,0,0,0,0,0,20230806,0-3,심야
3:00 ~ 5:59,0,0,0,0,0,0,20230806,3-6,심야
6:00 ~ 8:59,0,0,0,0,0,0,20230806,6-9,심야
9:00 ~ 11:59,666,666,2845,3527,107394090,6372,20230806,9-12,주간
12:00 ~ 14:59,1313,1313,7216,7806,396534010,15022,20230806,12-15,주간
15:00 ~ 17:59,1481,1481,5522,9109,335505390,14631,20230806,15-18,주간
18:00 ~ 20:59,1815,1815,8873,8552,522319980,17425,20230806,18-21,저녁
21:00 ~ 23:59,7,7,13,38,628100,51,20230806,21-24,저녁
합계,5282,5282,24469,29032,1362381570,53501,20230806,,
00:00 ~ 2:59,0,0,0,0,0,0,20230807,0-3,심야
3:00 ~ 5:59,0,0,0,0,0,0,20230807,3-6,심야
6:00 ~ 8:59,0,0,0,0,0,0,20230807,6-9,심야
9:00 ~ 11:59,756,756,2687,4192,116395530,6879,20230807,9-12,주간
12:00 ~ 14:59,1322,1322,6366,21136,656719577,27502,20230807,12-15,주간
15:00 ~ 17:59,1598,1598,5383,9729,483065660,15112,20230807,15-18,주간
18:00 ~ 20:59,2140,2140,24465,20724,1769997045,45189,20230807,18-21,저녁
21:00 ~ 23:59,7,7,10,65,595650,75,20230807,21-24,저녁
합계,5823,5823,38911,55846,3026773462,94757,20230807,,
00:00 ~ 2:59,0,0,0,0,0,0,20230808,0-3,심야
3:00 ~ 5:59,0,0,0,0,0,0,20230808,3-6,심야
6:00 ~ 8:59,0,0,0,0,0,0,20230808,6-9,심야
9:00 ~ 11:59,730,730,3771,4934,111189980,8705,20230808,9-12,주간
12:00 ~ 14:59,1335,1335,11039,20200,1474621889,31239,20230808,12-15,주간
15:00 ~ 17:59,1592,1592,7730,15980,652342030,23710,20230808,15-18,주간
18:00 ~ 20:59,2234,2234,25496,41012,1946007587,66508,20230808,18-21,저녁
21:00 ~ 23:59,6,6,8,47,963500,55,20230808,21-24,저녁
합계,5897,5897,48044,82173,4185124986,130217,20230808,,
00:00 ~ 2:59,0,0,0,0,0,0,20230809,0-3,심야
3:00 ~ 5:59,0,0,0,0,0,0,20230809,3-6,심야
6:00 ~ 8:59,0,0,0,0,0,0,20230809,6-9,심야
9:00 ~ 11:59,688,688,4210,3546,71247010,7756,20230809,9-12,주간
12:00 ~ 14:59,1343,1343,11437,22156,1887900840,33593,20230809,12-15,주간
15:00 ~ 17:59,1643,1643,7647,14556,565963610,22203,20230809,15-18,주간
18:00 ~ 20:59,2330,2330,26231,40905,2409373498,67136,20230809,18-21,저녁
21:00 ~ 23:59,9,9,22,28,404400,50,20230809,21-24,저녁
합계,6013,6013,49547,81191,4934889358,130738,20230809,,
00:00 ~ 2:59,0,0,0,0,0,0,20230810,0-3,심야
3:00 ~ 5:59,0,0,0,0,0,0,20230810,3-6,심야
6:00 ~ 8:59,0,0,0,0,0,0,20230810,6-9,심야
9:00 ~ 11:59,663,663,3790,3984,81208070,7774,20230810,9-12,주간
12:00 ~ 14:59,1304,1304,9622,10836,657714535,20458,20230810,12-15,주간
15:00 ~ 17:59,1677,1677,7909,16842,935537770,24751,20230810,15-18,주간
18:00 ~ 20:59,2293,2293,22999,64535,7451493689,87534,20230810,18-21,저녁
21:00 ~ 23:59,5,5,10,28,368500,38,20230810,21-24,저녁
합계,5942,5942,44330,96225,9126322564,140555,20230810,,
00:00 ~ 2:59,0,0,0,0,0,0,20230811,0-3,심야
3:00 ~ 5:59,0,0,0,0,0,0,20230811,3-6,심야
6:00 ~ 8:59,0,0,0,0,0,0,20230811,6-9,심야
9:00 ~ 11:59,699,699,3116,5535,126380130,8651,20230811,9-12,주간
12:00 ~ 14:59,1404,1404,11560,23846,1929559226,35406,20230811,12-15,주간
15:00 ~ 17:59,1761,1761,7636,16382,628944660,24018,20230811,15-18,주간
18:00 ~ 20:59,2313,2313,20100,38716,3327567390,58816,20230811,18-21,저녁
21:00 ~ 23:59,6,6,7,30,428100,37,20230811,21-24,저녁
합계,6183,6183,42419,84509,6012879506,126928,20230811,,
00:00 ~ 2:59,0,0,0,0,0,0,20230812,0-3,심야
3:00 ~ 5:59,0,0,0,0,0,0,20230812,3-6,심야
6:00 ~ 8:59,0,0,0,0,0,0,20230812,6-9,심야
9:00 ~ 11:59,628,628,2519,3963,95349560,6482,20230812,9-12,주간
12:00 ~ 14:59,1321,1321,8666,13766,671886564,22432,20230812,12-15,주간
15:00 ~ 17:59,1676,1676,6574,11853,448278985,18427,20230812,15-18,주간
18:00 ~ 20:59,2018,2018,13461,22395,2204796848,35856,20230812,18-21,저녁
21:00 ~ 23:59,6,6,34,3,10000,37,20230812,21-24,저녁
합계,5649,5649,31254,51980,3420321957,83234,20230812,,
00:00 ~ 2:59,0,0,0,0,0,0,20230813,0-3,심야
3:00 ~ 5:59,0,0,0,0,0,0,20230813,3-6,심야
6:00 ~ 8:59,0,0,0,0,0,0,20230813,6-9,심야
9:00 ~ 11:59,564,564,2132,3547,83581955,5679,20230813,9-12,주간
12:00 ~ 14:59,1229,1229,7648,10422,537178645,18070,20230813,12-15,주간
15:00 ~ 17:59,1502,1502,5051,10183,356595873,15234,20230813,15-18,주간
18:00 ~ 20:59,1936,1936,10597,11138,768634051,21735,20230813,18-21,저녁
21:00 ~ 23:59,3,3,6,24,239100,30,20230813,21-24,저녁
합계,5234,5234,25434,35314,1746229624,60748,20230813,,
00:00 ~ 2:59,1,1,3,-2,-117000,1,20230814,0-3,심야
3:00 ~ 5:59,0,0,0,0,0,0,20230814,3-6,심야
6:00 ~ 8:59,0,0,0,0,0,0,20230814,6-9,심야
9:00 ~ 11:59,610,610,2267,4864,113964210,7131,20230814,9-12,주간
12:00 ~ 14:59,1224,1224,6500,12281,455068243,18781,20230814,12-15,주간
15:00 ~ 17:59,1526,1526,6197,14719,726606110,20916,20230814,15-18,주간
18:00 ~ 20:59,2154,2154,19689,23534,919750498,43223,20230814,18-21,저녁
21:00 ~ 23:59,5,5,12,26,303700,38,20230814,21-24,저녁
합계,5520,5520,34668,55422,2215575761,90090,20230814,,
00:00 ~ 2:59,0,0,0,0,0,0,20230815,0-3,심야
3:00 ~ 5:59,0,0,0,0,0,0,20230815,3-6,심야
6:00 ~ 8:59,0,0,0,0,0,0,20230815,6-9,심야
9:00 ~ 11:59,581,581,2096,3543,80048720,5639,20230815,9-12,주간
12:00 ~ 14:59,1199,1199,7003,8608,370728049,15611,20230815,12-15,주간
15:00 ~ 17:59,1502,1502,5496,13271,510940861,18767,20230815,15-18,주간
18:00 ~ 20:59,1997,1997,11086,8771,456228777,19857,20230815,18-21,저녁
21:00 ~ 23:59,6,6,2,27,375000,29,20230815,21-24,저녁
합계,5285,5285,25683,34220,1418321407,59903,20230815,,
00:00 ~ 2:59,0,0,0,0,0,0,20230816,0-3,심야
3:00 ~ 5:59,0,0,0,0,0,0,20230816,3-6,심야
6:00 ~ 8:59,0,0,0,0,0,0,20230816,6-9,심야
9:00 ~ 11:59,596,596,2093,3985,85622720,6078,20230816,9-12,주간
12:00 ~ 14:59,1199,1199,7163,11956,416875052,19119,20230816,12-15,주간
15:00 ~ 17:59,1572,1572,8307,8601,459780184,16908,20230816,15-18,주간
18:00 ~ 20:59,2260,2260,24612,23152,852315792,47764,20230816,18-21,저녁
21:00 ~ 23:59,9,9,25,48,1304450,73,20230816,21-24,저녁
합계,5636,5636,42200,47742,1815898198,89942,20230816,,
00:00 ~ 2:59,0,0,0,0,0,0,20230817,0-3,심야
3:00 ~ 5:59,0,0,0,0,0,0,20230817,3-6,심야
6:00 ~ 8:59,0,0,0,0,0,0,20230817,6-9,심야
9:00 ~ 11:59,557,557,4326,3641,97324745,7967,20230817,9-12,주간
12:00 ~ 14:59,1192,1192,7458,9111,443227530,16569,20230817,12-15,주간
15:00 ~ 17:59,1586,1586,6259,12683,371923200,18942,20230817,15-18,주간
18:00 ~ 20:59,2339,2339,18740,30269,923765112,49009,20230817,18-21,저녁
21:00 ~ 23:59,6,6,12,35,810300,47,20230817,21-24,저녁
합계,5680,5680,36795,55739,1837050887,92534,20230817,,
00:00 ~ 2:59,0,0,0,0,0,0,20230818,0-3,심야
3:00 ~ 5:59,0,0,0,0,0,0,20230818,3-6,심야
6:00 ~ 8:59,0,0,0,0,0,0,20230818,6-9,심야
9:00 ~ 11:59,584,584,3371,4536,107008770,7907,20230818,9-12,주간
12:00 ~ 14:59,1250,1250,7340,14004,547365428,21344,20230818,12-15,주간
15:00 ~ 17:59,1683,1683,7872,16261,534707540,24133,20230818,15-18,주간
18:00 ~ 20:59,2270,2270,13034,28116,1031595760,41150,20230818,18-21,저녁
21:00 ~ 23:59,7,7,26,80,700300,106,20230818,21-24,저녁
합계,5794,5794,31643,62997,2221377798,94640,20230818,,
00:00 ~ 2:59,0,0,0,0,0,0,20230819,0-3,심야
3:00 ~ 5:59,2,2,0,31,0,31,20230819,3-6,심야
6:00 ~ 8:59,0,0,0,0,0,0,20230819,6-9,심야
9:00 ~ 11:59,542,542,2448,4418,87062385,6866,20230819,9-12,주간
12:00 ~ 14:59,1159,1159,8056,7232,407396995,15288,20230819,12-15,주간
15:00 ~ 17:59,1511,1511,6512,11650,376945620,18162,20230819,15-18,주간
18:00 ~ 20:59,1947,1947,9259,10056,577788624,19315,20230819,18-21,저녁
21:00 ~ 23:59,6,6,1,50,1362400,51,20230819,21-24,저녁
합계,5167,5167,26276,33437,1450556024,59713,20230819,,
00:00 ~ 2:59,0,0,0,0,0,0,20230820,0-3,심야
3:00 ~ 5:59,1,1,0,30,0,30,20230820,3-6,심야
6:00 ~ 8:59,0,0,0,0,0,0,20230820,6-9,심야
9:00 ~ 11:59,472,472,1672,2729,69480010,4401,20230820,9-12,주간
12:00 ~ 14:59,1019,1019,6370,6767,378013470,13137,20230820,12-15,주간
15:00 ~ 17:59,1363,1363,4236,8520,323615510,12756,20230820,15-18,주간
18:00 ~ 20:59,1890,1890,8074,8035,517727940,16109,20230820,18-21,저녁
21:00 ~ 23:59,4,4,10,13,550000,23,20230820,21-24,저녁
합계,4749,4749,20362,26094,1289386930,46456,20230820,,
00:00 ~ 2:59,0,0,0,0,0,0,20230821,0-3,심야
3:00 ~ 5:59,0,0,0,0,0,0,20230821,3-6,심야
6:00 ~ 8:59,0,0,0,0,0,0,20230821,6-9,심야
9:00 ~ 11:59,514,514,1280,2743,75045760,4023,20230821,9-12,주간
12:00 ~ 14:59,1038,1038,4993,9490,713380630,14483,20230821,12-15,주간
15:00 ~ 17:59,1432,1432,4944,10622,321505990,15566,20230821,15-18,주간
18:00 ~ 20:59,2187,2187,14826,35066,1260894690,49892,20230821,18-21,저녁
21:00 ~ 23:59,5,5,8,22,961000,30,20230821,21-24,저녁
합계,5176,5176,26051,57943,2371788070,83994,20230821,,
00:00 ~ 2:59,0,0,0,0,0,0,20230822,0-3,심야
3:00 ~ 5:59,1,1,0,30,0,30,20230822,3-6,심야
6:00 ~ 8:59,0,0,0,0,0,0,20230822,6-9,심야
9:00 ~ 11:59,534,534,2535,3455,102501045,5990,20230822,9-12,주간
12:00 ~ 14:59,1018,1018,6354,9960,606863660,16314,20230822,12-15,주간
15:00 ~ 17:59,1475,1475,6561,15307,1021988052,21868,20230822,15-18,주간
18:00 ~ 20:59,2280,2280,19294,38267,3019744540,57561,20230822,18-21,저녁
21:00 ~ 23:59,7,7,2,16,497200,18,20230822,21-24,저녁
합계,5315,5315,34746,67035,4751594497,101781,20230822,,
00:00 ~ 2:59,0,0,0,0,0,0,20230823,0-3,심야
3:00 ~ 5:59,0,0,0,0,0,0,20230823,3-6,심야
6:00 ~ 8:59,0,0,0,0,0,0,20230823,6-9,심야
9:00 ~ 11:59,521,521,2822,2912,104366290,5734,20230823,9-12,주간
12:00 ~ 14:59,1083,1083,7025,9692,891601780,16717,20230823,12-15,주간
15:00 ~ 17:59,1508,1508,6623,23001,843003560,29624,20230823,15-18,주간
18:00 ~ 20:59,2268,2268,20137,30172,1931808750,50309,20230823,18-21,저녁
21:00 ~ 23:59,7,7,3,19,338400,22,20230823,21-24,저녁
합계,5387,5387,36610,65796,3771118780,102406,20230823,,
00:00 ~ 2:59,0,0,0,0,0,0,20230824,0-3,심야
3:00 ~ 5:59,0,0,0,0,0,0,20230824,3-6,심야
6:00 ~ 8:59,0,0,0,0,0,0,20230824,6-9,심야
9:00 ~ 11:59,520,520,2835,3131,80300310,5966,20230824,9-12,주간
12:00 ~ 14:59,1125,1125,19326,21699,2535585525,41025,20230824,12-15,주간
15:00 ~ 17:59,1497,1497,6301,12616,677477840,18917,20230824,15-18,주간
18:00 ~ 20:59,2255,2255,22067,46270,2945068610,68337,20230824,18-21,저녁
21:00 ~ 23:59,5,5,6,24,407200,30,20230824,21-24,저녁
합계,5402,5402,50535,83740,6238839485,134275,20230824,,
00:00 ~ 2:59,0,0,0,0,0,0,20230825,0-3,심야
3:00 ~ 5:59,0,0,0,0,0,0,20230825,3-6,심야
6:00 ~ 8:59,0,0,0,0,0,0,20230825,6-9,심야
9:00 ~ 11:59,513,513,3299,3091,86425830,6390,20230825,9-12,주간
12:00 ~ 14:59,1129,1129,9954,11297,700482700,21251,20230825,12-15,주간
15:00 ~ 17:59,1544,1544,6883,15619,609404710,22502,20230825,15-18,주간
18:00 ~ 20:59,2236,2236,18580,30667,1272848010,49247,20230825,18-21,저녁
21:00 ~ 23:59,4,4,16,22,567200,38,20230825,21-24,저녁
합계,5426,5426,38732,60696,2669728450,99428,20230825,,
00:00 ~ 2:59,0,0,0,0,0,0,20230826,0-3,심야
3:00 ~ 5:59,0,0,0,0,0,0,20230826,3-6,심야
6:00 ~ 8:59,0,0,0,0,0,0,20230826,6-9,심야
9:00 ~ 11:59,494,494,2189,2239,69970480,4428,20230826,9-12,주간
12:00 ~ 14:59,1124,1124,10439,6251,483244750,16690,20230826,12-15,주간
15:00 ~ 17:59,1442,1442,7221,11045,552204990,18266,20230826,15-18,주간
18:00 ~ 20:59,1948,1948,12071,12813,826040230,24884,20230826,18-21,저녁
21:00 ~ 23:59,2,2,0,20,414000,20,20230826,21-24,저녁
합계,5010,5010,31920,32368,1931874450,64288,20230826,,
00:00 ~ 2:59,0,0,0,0,0,0,20230827,0-3,심야
3:00 ~ 5:59,0,0,0,0,0,0,20230827,3-6,심야
6:00 ~ 8:59,0,0,0,0,0,0,20230827,6-9,심야
9:00 ~ 11:59,460,460,1873,1736,58972270,3609,20230827,9-12,주간
12:00 ~ 14:59,989,989,8248,4971,444644710,13219,20230827,12-15,주간
15:00 ~ 17:59,1364,1364,5353,9293,564770552,14646,20230827,15-18,주간
18:00 ~ 20:59,1863,1863,12118,9705,710123570,21823,20230827,18-21,저녁
21:00 ~ 23:59,5,5,2,9,288000,11,20230827,21-24,저녁
합계,4681,4681,27594,25714,1778799102,53308,20230827,,
00:00 ~ 2:59,0,0,0,0,0,0,20230828,0-3,심야
3:00 ~ 5:59,0,0,0,0,0,0,20230828,3-6,심야
6:00 ~ 8:59,0,0,0,0,0,0,20230828,6-9,심야
9:00 ~ 11:59,459,459,969,2721,53739520,3690,20230828,9-12,주간
12:00 ~ 14:59,1051,1051,15168,8160,534514660,23328,20230828,12-15,주간
15:00 ~ 17:59,1374,1374,8869,13960,1158224630,22829,20230828,15-18,주간
18:00 ~ 20:59,2129,2129,19444,24613,1462909650,44057,20230828,18-21,저녁
21:00 ~ 23:59,5,5,2,9,219000,11,20230828,21-24,저녁
합계,5018,5018,44452,49463,3209607460,93915,20230828,,
00:00 ~ 2:59,0,0,0,0,0,0,20230829,0-3,심야
3:00 ~ 5:59,2,2,1,99,0,100,20230829,3-6,심야
6:00 ~ 8:59,0,0,0,0,0,0,20230829,6-9,심야
9:00 ~ 11:59,499,499,1636,2770,74362880,4406,20230829,9-12,주간
12:00 ~ 14:59,1089,1089,7406,13921,1118175600,21327,20230829,12-15,주간
15:00 ~ 17:59,1446,1446,8447,21833,1123056878,30280,20230829,15-18,주간
18:00 ~ 20:59,2291,2291,22270,64964,6187661170,87234,20230829,18-21,저녁
21:00 ~ 23:59,8,8,4,14,424000,18,20230829,21-24,저녁
합계,5335,5335,39764,103601,8503680528,143365,20230829,,
00:00 ~ 2:59,0,0,0,0,0,0,20230830,0-3,심야
3:00 ~ 5:59,2,2,0,168,0,168,20230830,3-6,심야
6:00 ~ 8:59,0,0,0,0,0,0,20230830,6-9,심야
9:00 ~ 11:59,463,463,1744,2901,67801560,4645,20230830,9-12,주간
12:00 ~ 14:59,1098,1098,6821,11217,644890360,18038,20230830,12-15,주간
15:00 ~ 17:59,1482,1482,7687,14917,812554390,22604,20230830,15-18,주간
18:00 ~ 20:59,2296,2296,19699,31472,1908815740,51171,20230830,18-21,저녁
21:00 ~ 23:59,7,7,61,169,5358550,230,20230830,21-24,저녁
합계,5348,5348,36012,60844,3439420600,96856,20230830,,
00:00 ~ 2:59,0,0,0,0,0,0,20230831,0-3,심야
3:00 ~ 5:59,2,2,4,236,0,240,20230831,3-6,심야
6:00 ~ 8:59,0,0,0,0,0,0,20230831,6-9,심야
9:00 ~ 11:59,510,510,1437,4664,89695580,6101,20230831,9-12,주간
12:00 ~ 14:59,1184,1184,7094,9674,442941266,16768,20230831,12-15,주간
15:00 ~ 17:59,1523,1523,7703,16037,607096310,23740,20230831,15-18,주간
18:00 ~ 20:59,2295,2295,18853,29265,1672683190,48118,20230831,18-21,저녁
21:00 ~ 23:59,7,7,21,23,660200,44,20230831,21-24,저녁
합계,5521,5521,35112,59899,2813076546,95011,20230831,,
00:00 ~ 2:59,0,0,0,0,0,0,20230901,0-3,심야
3:00 ~ 5:59,1,1,0,8,0,8,20230901,3-6,심야
6:00 ~ 8:59,0,0,0,0,0,0,20230901,6-9,심야
9:00 ~ 11:59,550,550,1402,4829,102975742,6231,20230901,9-12,주간
12:00 ~ 14:59,1267,1267,8595,18329,1132393640,26924,20230901,12-15,주간
15:00 ~ 17:59,1566,1566,7552,15720,587136578,23272,20230901,15-18,주간
18:00 ~ 20:59,2393,2393,28806,25334,2252174430,54140,20230901,18-21,저녁
21:00 ~ 23:59,7,7,24,68,1544400,92,20230901,21-24,저녁
합계,5784,5784,46379,64288,4076224790,110667,20230901,,
00:00 ~ 2:59,0,0,0,0,0,0,20230902,0-3,심야
3:00 ~ 5:59,0,0,0,0,0,0,20230902,3-6,심야
6:00 ~ 8:59,0,0,0,0,0,0,20230902,6-9,심야
9:00 ~ 11:59,496,496,1436,3024,66913870,4460,20230902,9-12,주간
12:00 ~ 14:59,1161,1161,6850,8939,606462070,15789,20230902,12-15,주간
15:00 ~ 17:59,1482,1482,6338,12554,446895420,18892,20230902,15-18,주간
18:00 ~ 20:59,2013,2013,12498,15201,982212390,27699,20230902,18-21,저녁
21:00 ~ 23:59,8,8,11,59,1380400,70,20230902,21-24,저녁
합계,5160,5160,27133,39777,2103864150,66910,20230902,,
00:00 ~ 2:59,0,0,0,0,0,0,20230903,0-3,심야
3:00 ~ 5:59,0,0,0,0,0,0,20230903,3-6,심야
6:00 ~ 8:59,0,0,0,0,0,0,20230903,6-9,심야
9:00 ~ 11:59,467,467,965,2055,52196920,3020,20230903,9-12,주간
12:00 ~ 14:59,1105,1105,5403,7006,463199260,12409,20230903,12-15,주간
15:00 ~ 17:59,1341,1341,5092,9044,354864970,14136,20230903,15-18,주간
18:00 ~ 20:59,1989,1989,10162,10973,726415540,21135,20230903,18-21,저녁
21:00 ~ 23:59,7,7,20,-4,32000,16,20230903,21-24,저녁
합계,4909,4909,21642,29074,1596708690,50716,20230903,,
00:00 ~ 2:59,0,0,0,0,0,0,20230904,0-3,심야
3:00 ~ 5:59,0,0,0,0,0,0,20230904,3-6,심야
6:00 ~ 8:59,0,0,0,0,0,0,20230904,6-9,심야
9:00 ~ 11:59,492,492,1531,3988,79540250,5519,20230904,9-12,주간
12:00 ~ 14:59,1101,1101,5414,8441,443100490,13855,20230904,12-15,주간
15:00 ~ 17:59,1397,1397,6620,23228,1545724910,29848,20230904,15-18,주간
18:00 ~ 20:59,2185,2185,13630,37058,1988842020,50688,20230904,18-21,저녁
21:00 ~ 23:59,8,8,14,35,1402900,49,20230904,21-24,저녁
합계,5183,5183,27209,72750,4058610570,99959,20230904,,
00:00 ~ 2:59,0,0,0,0,0,0,20230905,0-3,심야
3:00 ~ 5:59,0,0,0,0,0,0,20230905,3-6,심야
6:00 ~ 8:59,0,0,0,0,0,0,20230905,6-9,심야
9:00 ~ 11:59,516,516,1273,3517,74443110,4790,20230905,9-12,주간
12:00 ~ 14:59,1118,1118,6330,9135,481244652,15465,20230905,12-15,주간
15:00 ~ 17:59,1379,1379,6773,15348,946369980,22121,20230905,15-18,주간
18:00 ~ 20:59,2267,2267,17106,31712,1827604622,48818,20230905,18-21,저녁
21:00 ~ 23:59,13,13,32,27,123200,59,20230905,21-24,저녁
합계,5293,5293,31514,59739,3329785564,91253,20230905,,
00:00 ~ 2:59,0,0,0,0,0,0,20230906,0-3,심야
3:00 ~ 5:59,0,0,0,0,0,0,20230906,3-6,심야
6:00 ~ 8:59,0,0,0,0,0,0,20230906,6-9,심야
9:00 ~ 11:59,508,508,1808,4201,101350720,6009,20230906,9-12,주간
12:00 ~ 14:59,1127,1127,6504,11833,722054730,18337,20230906,12-15,주간
15:00 ~ 17:59,1434,1434,6491,11727,930086010,18218,20230906,15-18,주간
18:00 ~ 20:59,2272,2272,20250,31475,2463586652,51725,20230906,18-21,저녁
21:00 ~ 23:59,11,11,9,34,516200,43,20230906,21-24,저녁
합계,5352,5352,35062,59270,4217594312,94332,20230906,,
00:00 ~ 2:59,0,0,0,0,0,0,20230907,0-3,심야
3:00 ~ 5:59,0,0,0,0,0,0,20230907,3-6,심야
6:00 ~ 8:59,0,0,0,0,0,0,20230907,6-9,심야
9:00 ~ 11:59,524,524,1278,5363,82623390,6641,20230907,9-12,주간
12:00 ~ 14:59,1164,1164,6557,13061,812743320,19618,20230907,12-15,주간
15:00 ~ 17:59,1442,1442,7434,14169,520528430,21603,20230907,15-18,주간
18:00 ~ 20:59,2314,2314,23194,34973,2413996310,58167,20230907,18-21,저녁
21:00 ~ 23:59,14,14,13,24,163550,37,20230907,21-24,저녁
합계,5458,5458,38476,67590,3830055000,106066,20230907,,
00:00 ~ 2:59,0,0,0,0,0,0,20230908,0-3,심야
3:00 ~ 5:59,0,0,0,0,0,0,20230908,3-6,심야
6:00 ~ 8:59,0,0,0,0,0,0,20230908,6-9,심야
9:00 ~ 11:59,551,551,1753,4383,99416200,6136,20230908,9-12,주간
12:00 ~ 14:59,1237,1237,8024,15275,727348632,23299,20230908,12-15,주간
15:00 ~ 17:59,1508,1508,7402,17178,605314200,24580,20230908,15-18,주간
18:00 ~ 20:59,2320,2320,20210,44953,3038372720,65163,20230908,18-21,저녁
21:00 ~ 23:59,8,8,9,27,706100,36,20230908,21-24,저녁
합계,5624,5624,37398,81816,4471157852,119214,20230908,,
00:00 ~ 2:59,0,0,0,0,0,0,20230909,0-3,심야
3:00 ~ 5:59,0,0,0,0,0,0,20230909,3-6,심야
6:00 ~ 8:59,0,0,0,0,0,0,20230909,6-9,심야
9:00 ~ 11:59,497,497,1207,2722,69777410,3929,20230909,9-12,주간
12:00 ~ 14:59,1180,1180,6146,7461,432463430,13607,20230909,12-15,주간
15:00 ~ 17:59,1449,1449,7298,11829,400028585,19127,20230909,15-18,주간
18:00 ~ 20:59,1974,1974,13019,10975,971995550,23994,20230909,18-21,저녁
21:00 ~ 23:59,10,10,13,19,331000,32,20230909,21-24,저녁
합계,5110,5110,27683,33006,1874595975,60689,20230909,,
00:00 ~ 2:59,0,0,0,0,0,0,20230910,0-3,심야
3:00 ~ 5:59,0,0,0,0,0,0,20230910,3-6,심야
6:00 ~ 8:59,0,0,0,0,0,0,20230910,6-9,심야
9:00 ~ 11:59,477,477,1063,2429,66740650,3492,20230910,9-12,주간
12:00 ~ 14:59,1119,1119,4990,6819,379276930,11809,20230910,12-15,주간
15:00 ~ 17:59,1300,1300,5142,8214,331019442,13356,20230910,15-18,주간
18:00 ~ 20:59,1952,1952,17256,2848,-584913930,20104,20230910,18-21,저녁
21:00 ~ 23:59,10,10,6,17,352000,23,20230910,21-24,저녁
합계,4858,4858,28457,20327,192475092,48784,20230910,,
00:00 ~ 2:59,0,0,0,0,0,0,20230911,0-3,심야
3:00 ~ 5:59,0,0,0,0,0,0,20230911,3-6,심야
6:00 ~ 8:59,0,0,0,0,0,0,20230911,6-9,심야
9:00 ~ 11:59,476,476,1673,2482,65017110,4155,20230911,9-12,주간
12:00 ~ 14:59,1062,1062,6584,8483,560694430,15067,20230911,12-15,주간
15:00 ~ 17:59,1291,1291,4842,7234,326746360,12076,20230911,15-18,주간
18:00 ~ 20:59,2167,2167,14660,18891,940746570,33551,20230911,18-21,저녁
21:00 ~ 23:59,10,10,13,25,558200,38,20230911,21-24,저녁
합계,5006,5006,27772,37115,1893762670,64887,20230911,,
00:00 ~ 2:59,0,0,0,0,0,0,20230912,0-3,심야
3:00 ~ 5:59,0,0,0,0,0,0,20230912,3-6,심야
6:00 ~ 8:59,0,0,0,0,0,0,20230912,6-9,심야
9:00 ~ 11:59,508,508,1453,3768,87057970,5221,20230912,9-12,주간
12:00 ~ 14:59,1141,1141,6817,15435,1059377480,22252,20230912,12-15,주간
15:00 ~ 17:59,1419,1419,7498,15462,985483820,22960,20230912,15-18,주간
18:00 ~ 20:59,2301,2301,15890,28878,1641126750,44768,20230912,18-21,저녁
21:00 ~ 23:59,11,11,17,23,558600,40,20230912,21-24,저녁
합계,5380,5380,31675,63566,3773604620,95241,20230912,,
00:00 ~ 2:59,0,0,0,0,0,0,20230913,0-3,심야
3:00 ~ 5:59,0,0,0,0,0,0,20230913,3-6,심야
6:00 ~ 8:59,0,0,0,0,0,0,20230913,6-9,심야
9:00 ~ 11:59,475,475,1382,3442,64088690,4824,20230913,9-12,주간
12:00 ~ 14:59,1157,1157,8381,11557,873440350,19938,20230913,12-15,주간
15:00 ~ 17:59,1375,1375,7455,14164,943171110,21619,20230913,15-18,주간
18:00 ~ 20:59,2290,2290,17812,33140,1732426150,50952,20230913,18-21,저녁
21:00 ~ 23:59,9,9,32,26,623350,58,20230913,21-24,저녁
합계,5306,5306,35062,62329,3613749650,97391,20230913,,
00:00 ~ 2:59,0,0,0,0,0,0,20230914,0-3,심야
3:00 ~ 5:59,0,0,0,0,0,0,20230914,3-6,심야
6:00 ~ 8:59,0,0,0,0,0,0,20230914,6-9,심야
9:00 ~ 11:59,499,499,1428,3811,76811070,5239,20230914,9-12,주간
12:00 ~ 14:59,1191,1191,7483,10096,731711860,17579,20230914,12-15,주간
15:00 ~ 17:59,1455,1455,9270,11739,585205400,21009,20230914,15-18,주간
18:00 ~ 20:59,2306,2306,19743,103521,12449659990,123264,20230914,18-21,저녁
21:00 ~ 23:59,13,13,16,74,1746550,90,20230914,21-24,저녁
합계,5464,5464,37940,129241,13845134870,167181,20230914,,
00:00 ~ 2:59,0,0,0,0,0,0,20230915,0-3,심야
3:00 ~ 5:59,0,0,0,0,0,0,20230915,3-6,심야
6:00 ~ 8:59,0,0,0,0,0,0,20230915,6-9,심야
9:00 ~ 11:59,538,538,1866,5490,122924200,7356,20230915,9-12,주간
12:00 ~ 14:59,1260,1260,6086,12897,629001490,18983,20230915,12-15,주간
15:00 ~ 17:59,1530,1530,7324,15497,601506760,22821,20230915,15-18,주간
18:00 ~ 20:59,2293,2293,22989,34473,2094296002,57462,20230915,18-21,저녁
21:00 ~ 23:59,11,11,14,28,420750,42,20230915,21-24,저녁
합계,5632,5632,38279,68385,3448149202,106664,20230915,,
00:00 ~ 2:59,0,0,0,0,0,0,20230916,0-3,심야
3:00 ~ 5:59,0,0,0,0,0,0,20230916,3-6,심야
6:00 ~ 8:59,0,0,0,0,0,0,20230916,6-9,심야
9:00 ~ 11:59,486,486,1358,2971,79880540,4329,20230916,9-12,주간
12:00 ~ 14:59,1226,1226,5484,7443,464856730,12927,20230916,12-15,주간
15:00 ~ 17:59,1407,1407,6911,10511,446251020,17422,20230916,15-18,주간
18:00 ~ 20:59,1978,1978,13015,10982,845179210,23997,20230916,18-21,저녁
21:00 ~ 23:59,6,6,2,43,917550,45,20230916,21-24,저녁
합계,5103,5103,26770,31950,1837085050,58720,20230916,,
00:00 ~ 2:59,0,0,0,0,0,0,20230917,0-3,심야
3:00 ~ 5:59,0,0,0,0,0,0,20230917,3-6,심야
6:00 ~ 8:59,0,0,0,0,0,0,20230917,6-9,심야
9:00 ~ 11:59,466,466,1037,2395,71193030,3432,20230917,9-12,주간
12:00 ~ 14:59,1154,1154,4951,7426,460627660,12377,20230917,12-15,주간
15:00 ~ 17:59,1324,1324,4751,8430,377181700,13181,20230917,15-18,주간
18:00 ~ 20:59,1936,1936,10500,9592,752456340,20092,20230917,18-21,저녁
21:00 ~ 23:59,8,8,2,23,443800,25,20230917,21-24,저녁
합계,4888,4888,21241,27866,1661902530,49107,20230917,,
00:00 ~ 2:59,0,0,0,0,0,0,20230918,0-3,심야
3:00 ~ 5:59,0,0,0,0,0,0,20230918,3-6,심야
6:00 ~ 8:59,0,0,0,0,0,0,20230918,6-9,심야
9:00 ~ 11:59,477,477,1158,3491,72046970,4649,20230918,9-12,주간
12:00 ~ 14:59,1167,1167,12789,12760,1003305900,25549,20230918,12-15,주간
15:00 ~ 17:59,1296,1296,7208,22507,2296722952,29715,20230918,15-18,주간
18:00 ~ 20:59,2206,2206,15401,40079,3187529810,55480,20230918,18-21,저녁
21:00 ~ 23:59,10,10,6,51,1207800,57,20230918,21-24,저녁
합계,5156,5156,36562,78888,6560813432,115450,20230918,,
00:00 ~ 2:59,0,0,0,0,0,0,20230919,0-3,심야
3:00 ~ 5:59,0,0,0,0,0,0,20230919,3-6,심야
6:00 ~ 8:59,0,0,0,0,0,0,20230919,6-9,심야
9:00 ~ 11:59,506,506,1429,4316,95993470,5745,20230919,9-12,주간
12:00 ~ 14:59,1213,1213,8245,17423,1130691290,25668,20230919,12-15,주간
15:00 ~ 17:59,1426,1426,7482,20658,1333841400,28140,20230919,15-18,주간
18:00 ~ 20:59,2359,2359,19931,40143,2774700800,60074,20230919,18-21,저녁
21:00 ~ 23:59,14,14,3,50,1544100,53,20230919,21-24,저녁
합계,5518,5518,37090,82590,5336771060,119680,20230919,,
00:00 ~ 2:59,1,1,0,4,40000,4,20230920,0-3,심야
3:00 ~ 5:59,0,0,0,0,0,0,20230920,3-6,심야
6:00 ~ 8:59,0,0,0,0,0,0,20230920,6-9,심야
9:00 ~ 11:59,492,492,1737,3890,65704890,5627,20230920,9-12,주간
12:00 ~ 14:59,1222,1222,5812,9977,630168890,15789,20230920,12-15,주간
15:00 ~ 17:59,1406,1406,9317,15488,1154020770,24805,20230920,15-18,주간
18:00 ~ 20:59,2395,2395,23271,37133,1861295080,60404,20230920,18-21,저녁
21:00 ~ 23:59,10,10,11,25,979100,36,20230920,21-24,저녁
합계,5526,5526,40148,66517,3712208730,106665,20230920,,
00:00 ~ 2:59,0,0,0,0,0,0,20230921,0-3,심야
3:00 ~ 5:59,0,0,0,0,0,0,20230921,3-6,심야
6:00 ~ 8:59,0,0,0,0,0,0,20230921,6-9,심야
9:00 ~ 11:59,525,525,1421,4397,78631700,5818,20230921,9-12,주간
12:00 ~ 14:59,1257,1257,6642,12175,722456636,18817,20230921,12-15,주간
15:00 ~ 17:59,1419,1419,6688,23846,834375116,30534,20230921,15-18,주간
18:00 ~ 20:59,2381,2381,20653,48770,2475924498,69423,20230921,18-21,저녁
21:00 ~ 23:59,14,14,5,67,1484700,72,20230921,21-24,저녁
합계,5596,5596,35409,89255,4112872650,124664,20230921,,
00:00 ~ 2:59,0,0,0,0,0,0,20230922,0-3,심야
3:00 ~ 5:59,0,0,0,0,0,0,20230922,3-6,심야
6:00 ~ 8:59,0,0,0,0,0,0,20230922,6-9,심야
9:00 ~ 11:59,527,527,1220,5342,74552780,6562,20230922,9-12,주간
12:00 ~ 14:59,1285,1285,6321,10756,529904780,17077,20230922,12-15,주간
15:00 ~ 17:59,1514,1514,9391,19459,679445390,28850,20230922,15-18,주간
18:00 ~ 20:59,2346,2346,19768,37238,1941306340,57006,20230922,18-21,저녁
21:00 ~ 23:59,12,12,13,48,786400,61,20230922,21-24,저녁
합계,5684,5684,36713,72843,3225995690,109556,20230922,,
00:00 ~ 2:59,0,0,0,0,0,0,20230923,0-3,심야
3:00 ~ 5:59,0,0,0,0,0,0,20230923,3-6,심야
6:00 ~ 8:59,0,0,0,0,0,0,20230923,6-9,심야
9:00 ~ 11:59,456,456,1063,2155,64143030,3218,20230923,9-12,주간
12:00 ~ 14:59,1239,1239,6024,8609,480537580,14633,20230923,12-15,주간
15:00 ~ 17:59,1377,1377,7039,11089,408978720,18128,20230923,15-18,주간
18:00 ~ 20:59,2059,2059,12586,17247,1188620750,29833,20230923,18-21,저녁
21:00 ~ 23:59,9,9,4,47,1299800,51,20230923,21-24,저녁
합계,5140,5140,26716,39147,2143579880,65863,20230923,,
00:00 ~ 2:59,0,0,0,0,0,0,20230924,0-3,심야
3:00 ~ 5:59,0,0,0,0,0,0,20230924,3-6,심야
6:00 ~ 8:59,0,0,0,0,0,0,20230924,6-9,심야
9:00 ~ 11:59,445,445,913,1763,51356930,2676,20230924,9-12,주간
12:00 ~ 14:59,1207,1207,6310,6288,435569452,12598,20230924,12-15,주간
15:00 ~ 17:59,1289,1289,5458,6627,323884330,12085,20230924,15-18,주간
18:00 ~ 20:59,1990,1990,10615,11273,723243932,21888,20230924,18-21,저녁
21:00 ~ 23:59,8,8,3,7,150000,10,20230924,21-24,저녁
합계,4939,4939,23299,25958,1534204644,49257,20230924,,
00:00 ~ 2:59,0,0,0,0,0,0,20230925,0-3,심야
3:00 ~ 5:59,0,0,0,0,0,0,20230925,3-6,심야
6:00 ~ 8:59,0,0,0,0,0,0,20230925,6-9,심야
9:00 ~ 11:59,480,480,1361,3128,62464770,4489,20230925,9-12,주간
12:00 ~ 14:59,1171,1171,6253,11526,591589219,17779,20230925,12-15,주간
15:00 ~ 17:59,1397,1397,6288,13810,373814429,20098,20230925,15-18,주간
18:00 ~ 20:59,2267,2267,16243,22002,1017906130,38245,20230925,18-21,저녁
21:00 ~ 23:59,13,13,10,69,1398800,79,20230925,21-24,저녁
합계,5328,5328,30155,50535,2047173348,80690,20230925,,
00:00 ~ 2:59,0,0,0,0,0,0,20230926,0-3,심야
3:00 ~ 5:59,0,0,0,0,0,0,20230926,3-6,심야
6:00 ~ 8:59,0,0,0,0,0,0,20230926,6-9,심야
9:00 ~ 11:59,483,483,1526,3522,66977040,5048,20230926,9-12,주간
12:00 ~ 14:59,1192,1192,8189,12762,881855020,20951,20230926,12-15,주간
15:00 ~ 17:59,1413,1413,7747,14741,738793290,22488,20230926,15-18,주간
18:00 ~ 20:59,2367,2367,20461,36431,2252842670,56892,20230926,18-21,저녁
21:00 ~ 23:59,9,9,25,79,2031000,104,20230926,21-24,저녁
합계,5464,5464,37948,67535,3942499020,105483,20230926,,
00:00 ~ 2:59,0,0,0,0,0,0,20230927,0-3,심야
3:00 ~ 5:59,0,0,0,0,0,0,20230927,3-6,심야
6:00 ~ 8:59,0,0,0,0,0,0,20230927,6-9,심야
9:00 ~ 11:59,455,455,1224,2733,51072400,3957,20230927,9-12,주간
12:00 ~ 14:59,1240,1240,6045,14459,619677500,20504,20230927,12-15,주간
15:00 ~ 17:59,1470,1470,6431,13785,482683262,20216,20230927,15-18,주간
18:00 ~ 20:59,2390,2390,15199,33681,1573094750,48880,20230927,18-21,저녁
21:00 ~ 23:59,13,13,28,265,10401900,293,20230927,21-24,저녁
합계,5568,5568,28927,64923,2736929812,93850,20230927,,
00:00 ~ 2:59,0,0,0,0,0,0,20230928,0-3,심야
3:00 ~ 5:59,0,0,0,0,0,0,20230928,3-6,심야
6:00 ~ 8:59,0,0,0,0,0,0,20230928,6-9,심야
9:00 ~ 11:59,396,396,593,1461,38538160,2054,20230928,9-12,주간
12:00 ~ 14:59,1132,1132,4333,6878,436966300,11211,20230928,12-15,주간
15:00 ~ 17:59,1306,1306,4658,7089,329234980,11747,20230928,15-18,주간
18:00 ~ 20:59,2010,2010,8670,10603,798110960,19273,20230928,18-21,저녁
21:00 ~ 23:59,11,11,4,28,922000,32,20230928,21-24,저녁
합계,4855,4855,18258,26059,1603772400,44317,20230928,,
00:00 ~ 2:59,0,0,0,0,0,0,20230929,0-3,심야
3:00 ~ 5:59,0,0,0,0,0,0,20230929,3-6,심야
6:00 ~ 8:59,0,0,0,0,0,0,20230929,6-9,심야
9:00 ~ 11:59,345,345,541,1367,39467720,1908,20230929,9-12,주간
12:00 ~ 14:59,1065,1065,3807,5605,364743710,9412,20230929,12-15,주간
15:00 ~ 17:59,1213,1213,3376,6118,296668690,9494,20230929,15-18,주간
18:00 ~ 20:59,1904,1904,6699,8326,613383750,15025,20230929,18-21,저녁
21:00 ~ 23:59,7,7,3,26,862400,29,20230929,21-24,저녁
합계,4534,4534,14426,21442,1315126270,35868,20230929,,
00:00 ~ 2:59,0,0,0,0,0,0,20230930,0-3,심야
3:00 ~ 5:59,0,0,0,0,0,0,20230930,3-6,심야
6:00 ~ 8:59,0,0,0,0,0,0,20230930,6-9,심야
9:00 ~ 11:59,398,398,808,2064,44747430,2872,20230930,9-12,주간
12:00 ~ 14:59,1132,1132,4103,7694,376125280,11797,20230930,12-15,주간
15:00 ~ 17:59,1279,1279,5078,7608,282170720,12686,20230930,15-18,주간
18:00 ~ 20:59,1916,1916,7775,9837,601316370,17612,20230930,18-21,저녁
21:00 ~ 23:59,13,13,14,44,1199400,58,20230930,21-24,저녁
합계,4738,4738,17778,27247,1305559200,45025,20230930,,
00:00 ~ 2:59,0,0,0,0,0,0,20231001,0-3,심야
3:00 ~ 5:59,0,0,0,0,0,0,20231001,3-6,심야
6:00 ~ 8:59,0,0,0,0,0,0,20231001,6-9,심야
9:00 ~ 11:59,409,409,796,2327,53673000,3123,20231001,9-12,주간
12:00 ~ 14:59,1154,1154,4949,9357,432562766,14306,20231001,12-15,주간
15:00 ~ 17:59,1325,1325,3807,7671,319687254,11478,20231001,15-18,주간
18:00 ~ 20:59,1971,1971,6936,9671,579740782,16607,20231001,18-21,저녁
21:00 ~ 23:59,7,7,2,32,771100,34,20231001,21-24,저녁
합계,4866,4866,16490,29058,1386434902,45548,20231001,,
00:00 ~ 2:59,0,0,0,0,0,0,20231002,0-3,심야
3:00 ~ 5:59,0,0,0,0,0,0,20231002,3-6,심야
6:00 ~ 8:59,0,0,0,0,0,0,20231002,6-9,심야
9:00 ~ 11:59,413,413,870,2152,51817570,3022,20231002,9-12,주간
12:00 ~ 14:59,1094,1094,4171,14747,407286800,18918,20231002,12-15,주간
15:00 ~ 17:59,1349,1349,4224,6722,260158080,10946,20231002,15-18,주간
18:00 ~ 20:59,2000,2000,6569,19618,472248120,26187,20231002,18-21,저녁
21:00 ~ 23:59,11,11,15,32,502200,47,20231002,21-24,저녁
합계,4867,4867,15849,43271,1192012770,59120,20231002,,
00:00 ~ 2:59,0,0,0,0,0,0,20231003,0-3,심야
3:00 ~ 5:59,0,0,0,0,0,0,20231003,3-6,심야
6:00 ~ 8:59,0,0,0,0,0,0,20231003,6-9,심야
9:00 ~ 11:59,437,437,1063,1827,53211670,2890,20231003,9-12,주간
12:00 ~ 14:59,1121,1121,5578,6748,360427270,12326,20231003,12-15,주간
15:00 ~ 17:59,1337,1337,3915,5829,269729050,9744,20231003,15-18,주간
18:00 ~ 20:59,2082,2082,9026,8332,466478801,17358,20231003,18-21,저녁
21:00 ~ 23:59,12,12,12,42,858550,54,20231003,21-24,저녁
합계,4989,4989,19594,22778,1150705341,42372,20231003,,
00:00 ~ 2:59,0,0,0,0,0,0,20231004,0-3,심야
3:00 ~ 5:59,0,0,0,0,0,0,20231004,3-6,심야
6:00 ~ 8:59,0,0,0,0,0,0,20231004,6-9,심야
9:00 ~ 11:59,485,485,1448,4838,79809880,6286,20231004,9-12,주간
12:00 ~ 14:59,1143,1143,5621,10232,474219040,15853,20231004,12-15,주간
15:00 ~ 17:59,1434,1434,8422,12638,465545240,21060,20231004,15-18,주간
18:00 ~ 20:59,2381,2381,14329,33235,1790179130,47564,20231004,18-21,저녁
21:00 ~ 23:59,14,14,19,69,1868000,88,20231004,21-24,저녁
합계,5457,5457,29839,61012,2811621290,90851,20231004,,
00:00 ~ 2:59,0,0,0,0,0,0,20231005,0-3,심야
3:00 ~ 5:59,0,0,0,0,0,0,20231005,3-6,심야
6:00 ~ 8:59,0,0,0,0,0,0,20231005,6-9,심야
9:00 ~ 11:59,522,522,1775,5796,76868290,7571,20231005,9-12,주간
12:00 ~ 14:59,1184,1184,6590,12823,672559500,19413,20231005,12-15,주간
15:00 ~ 17:59,1529,1529,8642,20970,890103452,29612,20231005,15-18,주간
18:00 ~ 20:59,2424,2424,19169,61543,5490423980,80712,20231005,18-21,저녁
21:00 ~ 23:59,17,17,20,61,1488600,81,20231005,21-24,저녁
합계,5676,5676,36196,101193,7131443822,137389,20231005,,
00:00 ~ 2:59,0,0,0,0,0,0,20231006,0-3,심야
3:00 ~ 5:59,0,0,0,0,0,0,20231006,3-6,심야
6:00 ~ 8:59,0,0,0,0,0,0,20231006,6-9,심야
9:00 ~ 11:59,504,504,1326,4527,78262770,5853,20231006,9-12,주간
12:00 ~ 14:59,1312,1312,9250,20449,1485160420,29699,20231006,12-15,주간
15:00 ~ 17:59,1552,1552,8653,17213,618848330,25866,20231006,15-18,주간
18:00 ~ 20:59,2386,2386,22195,36396,2349578832,58591,20231006,18-21,저녁
21:00 ~ 23:59,21,21,12,71,1096200,83,20231006,21-24,저녁
합계,5775,5775,41436,78656,4532946552,120092,20231006,,
00:00 ~ 2:59,0,0,0,0,0,0,20231007,0-3,심야
3:00 ~ 5:59,0,0,0,0,0,0,20231007,3-6,심야
6:00 ~ 8:59,0,0,0,0,0,0,20231007,6-9,심야
9:00 ~ 11:59,455,455,948,2282,57050026,3230,20231007,9-12,주간
12:00 ~ 14:59,1216,1216,6446,8835,595447440,15281,20231007,12-15,주간
15:00 ~ 17:59,1410,1410,6932,10269,371249119,17201,20231007,15-18,주간
18:00 ~ 20:59,2102,2102,11210,13638,834836280,24848,20231007,18-21,저녁
21:00 ~ 23:59,10,10,14,15,107400,29,20231007,21-24,저녁
합계,5193,5193,25550,35039,1858690265,60589,20231007,,
00:00 ~ 2:59,1,1,0,1,10000,1,20231008,0-3,심야
3:00 ~ 5:59,0,0,0,0,0,0,20231008,3-6,심야
6:00 ~ 8:59,0,0,0,0,0,0,20231008,6-9,심야
9:00 ~ 11:59,413,413,952,1933,51267470,2885,20231008,9-12,주간
12:00 ~ 14:59,1116,1116,6541,8376,464368100,14917,20231008,12-15,주간
15:00 ~ 17:59,1284,1284,5499,8847,338148540,14346,20231008,15-18,주간
18:00 ~ 20:59,1960,1960,9906,13292,726278010,23198,20231008,18-21,저녁
21:00 ~ 23:59,7,7,8,33,352000,41,20231008,21-24,저녁
합계,4781,4781,22906,32482,1580424120,55388,20231008,,
00:00 ~ 2:59,0,0,0,0,0,0,20231009,0-3,심야
3:00 ~ 5:59,0,0,0,0,0,0,20231009,3-6,심야
6:00 ~ 8:59,0,0,0,0,0,0,20231009,6-9,심야
9:00 ~ 11:59,373,373,1003,1554,43848080,2557,20231009,9-12,주간
12:00 ~ 14:59,1010,1010,5229,6327,347593210,11556,20231009,12-15,주간
15:00 ~ 17:59,1290,1290,4466,7593,301243930,12059,20231009,15-18,주간
18:00 ~ 20:59,2005,2005,8913,10883,667796172,19796,20231009,18-21,저녁
21:00 ~ 23:59,7,7,6,12,-9000,18,20231009,21-24,저녁
합계,4685,4685,19617,26369,1360472392,45986,20231009,,
00:00 ~ 2:59,0,0,0,0,0,0,20231010,0-3,심야
3:00 ~ 5:59,0,0,0,0,0,0,20231010,3-6,심야
6:00 ~ 8:59,0,0,0,0,0,0,20231010,6-9,심야
9:00 ~ 11:59,446,446,1338,3232,70058460,4570,20231010,9-12,주간
12:00 ~ 14:59,1066,1066,5467,9739,586017860,15206,20231010,12-15,주간
15:00 ~ 17:59,1370,1370,15246,36786,2924279550,52032,20231010,15-18,주간
18:00 ~ 20:59,2403,2403,28490,54115,4310676155,82605,20231010,18-21,저녁
21:00 ~ 23:59,13,13,40,503,25272400,543,20231010,21-24,저녁
합계,5298,5298,50581,104375,7916304425,154956,20231010,,
00:00 ~ 2:59,0,0,0,0,0,0,20231011,0-3,심야
3:00 ~ 5:59,0,0,0,0,0,0,20231011,3-6,심야
6:00 ~ 8:59,0,0,0,0,0,0,20231011,6-9,심야
9:00 ~ 11:59,462,462,1440,3089,60153240,4529,20231011,9-12,주간
12:00 ~ 14:59,1156,1156,8293,14530,1337053250,22823,20231011,12-15,주간
15:00 ~ 17:59,1478,1478,17386,29050,2554154430,46436,20231011,15-18,주간
18:00 ~ 20:59,2459,2459,33522,59303,5858291570,92825,20231011,18-21,저녁
21:00 ~ 23:59,9,9,25,47,2765800,72,20231011,21-24,저녁
합계,5564,5564,60666,106019,9812418290,166685,20231011,,
00:00 ~ 2:59,0,0,0,0,0,0,20231012,0-3,심야
3:00 ~ 5:59,0,0,0,0,0,0,20231012,3-6,심야
6:00 ~ 8:59,0,0,0,0,0,0,20231012,6-9,심야
9:00 ~ 11:59,462,462,1714,2555,58771320,4269,20231012,9-12,주간
12:00 ~ 14:59,1188,1188,8208,16254,1282282720,24462,20231012,12-15,주간
15:00 ~ 17:59,1478,1478,12753,22159,1670698730,34912,20231012,15-18,주간
18:00 ~ 20:59,2588,2588,27625,51656,4020559950,79281,20231012,18-21,저녁
21:00 ~ 23:59,12,12,21,31,831500,52,20231012,21-24,저녁
합계,5728,5728,50321,92655,7033144220,142976,20231012,,
00:00 ~ 2:59,0,0,0,0,0,0,20231013,0-3,심야
3:00 ~ 5:59,4,4,8,470,0,478,20231013,3-6,심야
6:00 ~ 8:59,0,0,0,0,0,0,20231013,6-9,심야
9:00 ~ 11:59,473,473,1528,5055,74062530,6583,20231013,9-12,주간
12:00 ~ 14:59,1196,1196,8736,16056,1030060400,24792,20231013,12-15,주간
15:00 ~ 17:59,1506,1506,14928,20015,1498903912,34943,20231013,15-18,주간
18:00 ~ 20:59,2514,2514,26654,50801,3631870640,77455,20231013,18-21,저녁
21:00 ~ 23:59,10,10,7,55,1317300,62,20231013,21-24,저녁
합계,5703,5703,51861,92452,6236214782,144313,20231013,,
00:00 ~ 2:59,0,0,0,0,0,0,20231014,0-3,심야
3:00 ~ 5:59,0,0,0,0,0,0,20231014,3-6,심야
6:00 ~ 8:59,0,0,0,0,0,0,20231014,6-9,심야
9:00 ~ 11:59,436,436,1055,1980,51743890,3035,20231014,9-12,주간
12:00 ~ 14:59,1143,1143,9695,6546,519789060,16241,20231014,12-15,주간
15:00 ~ 17:59,1376,1376,8921,12719,541576880,21640,20231014,15-18,주간
18:00 ~ 20:59,2152,2152,20382,16516,1198938322,36898,20231014,18-21,저녁
21:00 ~ 23:59,6,6,11,53,1295100,64,20231014,21-24,저녁
합계,5113,5113,40064,37814,2313343252,77878,20231014,,
00:00 ~ 2:59,0,0,0,0,0,0,20231015,0-3,심야
3:00 ~ 5:59,0,0,0,0,0,0,20231015,3-6,심야
6:00 ~ 8:59,0,0,0,0,0,0,20231015,6-9,심야
9:00 ~ 11:59,391,391,932,1494,43626610,2426,20231015,9-12,주간
12:00 ~ 14:59,1064,1064,6464,6851,396613600,13315,20231015,12-15,주간
15:00 ~ 17:59,1314,1314,7185,9374,350841530,16559,20231015,15-18,주간
18:00 ~ 20:59,2101,2101,14513,13562,870827502,28075,20231015,18-21,저녁
21:00 ~ 23:59,15,15,6,46,929000,52,20231015,21-24,저녁
합계,4885,4885,29100,31327,1662838242,60427,20231015,,
00:00 ~ 2:59,0,0,0,0,0,0,20231016,0-3,심야
3:00 ~ 5:59,0,0,0,0,0,0,20231016,3-6,심야
6:00 ~ 8:59,0,0,0,0,0,0,20231016,6-9,심야
9:00 ~ 11:59,449,449,1524,4280,59813470,5804,20231016,9-12,주간
12:00 ~ 14:59,1042,1042,5424,9629,762823422,15053,20231016,12-15,주간
15:00 ~ 17:59,1338,1338,8535,10580,796173520,19115,20231016,15-18,주간
18:00 ~ 20:59,2415,2415,20075,27493,1694281990,47568,20231016,18-21,저녁
21:00 ~ 23:59,10,10,18,205,14187000,223,20231016,21-24,저녁
합계,5254,5254,35576,52187,3327279402,87763,20231016,,
00:00 ~ 2:59,0,0,0,0,0,0,20231017,0-3,심야
3:00 ~ 5:59,0,0,0,0,0,0,20231017,3-6,심야
6:00 ~ 8:59,0,0,0,0,0,0,20231017,6-9,심야
9:00 ~ 11:59,468,468,1534,2693,65095390,4227,20231017,9-12,주간
12:00 ~ 14:59,1064,1064,6024,12383,798193490,18407,20231017,12-15,주간
15:00 ~ 17:59,1418,1418,11326,27998,2195028220,39324,20231017,15-18,주간
18:00 ~ 20:59,2555,2555,25470,43680,2851305342,69150,20231017,18-21,저녁
21:00 ~ 23:59,15,15,16,67,2862550,83,20231017,21-24,저녁
합계,5520,5520,44370,86821,5912484992,131191,20231017,,
00:00 ~ 2:59,0,0,0,0,0,0,20231018,0-3,심야
3:00 ~ 5:59,0,0,0,0,0,0,20231018,3-6,심야
6:00 ~ 8:59,0,0,0,0,0,0,20231018,6-9,심야
9:00 ~ 11:59,504,504,1075,3684,77617000,4759,20231018,9-12,주간
12:00 ~ 14:59,1132,1132,6342,10412,505919512,16754,20231018,12-15,주간
15:00 ~ 17:59,1491,1491,12906,22069,1978266650,34975,20231018,15-18,주간
18:00 ~ 20:59,2622,2622,26180,39947,2769244442,66127,20231018,18-21,저녁
21:00 ~ 23:59,12,12,8,55,2143200,63,20231018,21-24,저녁
합계,5761,5761,46511,76167,5333190804,122678,20231018,,
00:00 ~ 2:59,0,0,0,0,0,0,20231019,0-3,심야
3:00 ~ 5:59,0,0,0,0,0,0,20231019,3-6,심야
6:00 ~ 8:59,0,0,0,0,0,0,20231019,6-9,심야
9:00 ~ 11:59,523,523,1930,5620,77850160,7550,20231019,9-12,주간
12:00 ~ 14:59,1133,1133,8251,20417,1405263770,28668,20231019,12-15,주간
15:00 ~ 17:59,1562,1562,12992,16755,1097694990,29747,20231019,15-18,주간
18:00 ~ 20:59,2678,2678,28844,87841,8417905540,116685,20231019,18-21,저녁
21:00 ~ 23:59,16,16,44,150,1499000,194,20231019,21-24,저녁
합계,5912,5912,52061,130783,11000213460,182844,20231019,,
00:00 ~ 2:59,0,0,0,0,0,0,20231020,0-3,심야
3:00 ~ 5:59,0,0,0,0,0,0,20231020,3-6,심야
6:00 ~ 8:59,0,0,0,0,0,0,20231020,6-9,심야
9:00 ~ 11:59,494,494,2017,3741,56637960,5758,20231020,9-12,주간
12:00 ~ 14:59,1220,1220,9205,17805,1456518870,27010,20231020,12-15,주간
15:00 ~ 17:59,1574,1574,10983,17130,921365952,28113,20231020,15-18,주간
18:00 ~ 20:59,2592,2592,28512,41809,3199506470,70321,20231020,18-21,저녁
21:00 ~ 23:59,15,15,608,593,75109450,1201,20231020,21-24,저녁
합계,5895,5895,51325,81078,5709138702,132403,20231020,,
00:00 ~ 2:59,0,0,0,0,0,0,20231021,0-3,심야
3:00 ~ 5:59,0,0,0,0,0,0,20231021,3-6,심야
6:00 ~ 8:59,0,0,0,0,0,0,20231021,6-9,심야
9:00 ~ 11:59,441,441,1288,1761,48782400,3049,20231021,9-12,주간
12:00 ~ 14:59,1130,1130,9019,7008,552255450,16027,20231021,12-15,주간
15:00 ~ 17:59,1440,1440,9227,11211,550386760,20438,20231021,15-18,주간
18:00 ~ 20:59,2247,2247,15910,19533,1301406672,35443,20231021,18-21,저녁
21:00 ~ 23:59,14,14,96,115,10909750,211,20231021,21-24,저녁
합계,5272,5272,35540,39628,2463741032,75168,20231021,,
00:00 ~ 2:59,0,0,0,0,0,0,20231022,0-3,심야
3:00 ~ 5:59,0,0,0,0,0,0,20231022,3-6,심야
6:00 ~ 8:59,0,0,0,0,0,0,20231022,6-9,심야
9:00 ~ 11:59,442,442,945,1459,48842250,2404,20231022,9-12,주간
12:00 ~ 14:59,1077,1077,6400,6875,566494310,13275,20231022,12-15,주간
15:00 ~ 17:59,1327,1327,6049,9412,509649252,15461,20231022,15-18,주간
18:00 ~ 20:59,2177,2177,12737,14047,1129942695,26784,20231022,18-21,저녁
21:00 ~ 23:59,13,13,71,100,8718500,171,20231022,21-24,저녁
합계,5036,5036,26202,31893,2263647007,58095,20231022,,
00:00 ~ 2:59,0,0,0,0,0,0,20231023,0-3,심야
3:00 ~ 5:59,0,0,0,0,0,0,20231023,3-6,심야
6:00 ~ 8:59,0,0,0,0,0,0,20231023,6-9,심야
9:00 ~ 11:59,482,482,994,2609,55048980,3603,20231023,9-12,주간
12:00 ~ 14:59,1118,1118,6401,10868,763022340,17269,20231023,12-15,주간
15:00 ~ 17:59,1416,1416,6635,10176,627934930,16811,20231023,15-18,주간
18:00 ~ 20:59,2554,2554,18913,38086,2326986010,56999,20231023,18-21,저녁
21:00 ~ 23:59,24,24,71,81,5336400,152,20231023,21-24,저녁
합계,5594,5594,33014,61820,3778328660,94834,20231023,,
00:00 ~ 2:59,1,1,0,2,30000,2,20231024,0-3,심야
3:00 ~ 5:59,0,0,0,0,0,0,20231024,3-6,심야
6:00 ~ 8:59,0,0,0,0,0,0,20231024,6-9,심야
9:00 ~ 11:59,521,521,2479,3391,80415050,5870,20231024,9-12,주간
12:00 ~ 14:59,1175,1175,6111,12052,943151540,18163,20231024,12-15,주간
15:00 ~ 17:59,1524,1524,8812,23476,2195484870,32288,20231024,15-18,주간
18:00 ~ 20:59,2668,2668,20562,42628,2613640162,63190,20231024,18-21,저녁
21:00 ~ 23:59,17,17,76,56,4071400,132,20231024,21-24,저녁
합계,5906,5906,38040,81605,5836793022,119645,20231024,,
00:00 ~ 2:59,0,0,0,0,0,0,20231025,0-3,심야
3:00 ~ 5:59,0,0,0,0,0,0,20231025,3-6,심야
6:00 ~ 8:59,0,0,0,0,0,0,20231025,6-9,심야
9:00 ~ 11:59,513,513,1459,3736,71267280,5195,20231025,9-12,주간
12:00 ~ 14:59,1213,1213,5822,15085,731473262,20907,20231025,12-15,주간
15:00 ~ 17:59,1620,1620,10902,18373,1213903000,29275,20231025,15-18,주간
18:00 ~ 20:59,2735,2735,28558,51713,3392141285,80271,20231025,18-21,저녁
21:00 ~ 23:59,18,18,48,92,1963500,140,20231025,21-24,저녁
합계,6099,6099,46789,88999,5410748327,135788,20231025,,
00:00 ~ 2:59,0,0,0,0,0,0,20231026,0-3,심야
3:00 ~ 5:59,0,0,0,0,0,0,20231026,3-6,심야
6:00 ~ 8:59,0,0,0,0,0,0,20231026,6-9,심야
9:00 ~ 11:59,537,537,1363,6612,62539710,7975,20231026,9-12,주간
12:00 ~ 14:59,1268,1268,6625,19351,1006659417,25976,20231026,12-15,주간
15:00 ~ 17:59,1645,1645,10599,28257,1836358520,38856,20231026,15-18,주간
18:00 ~ 20:59,2770,2770,35568,64357,6053387703,99925,20231026,18-21,저녁
21:00 ~ 23:59,24,24,56,64,1534000,120,20231026,21-24,저녁
합계,6244,6244,54211,118641,8960479350,172852,20231026,,
00:00 ~ 2:59,0,0,0,0,0,0,20231027,0-3,심야
3:00 ~ 5:59,4,4,0,440,0,440,20231027,3-6,심야
6:00 ~ 8:59,0,0,0,0,0,0,20231027,6-9,심야
9:00 ~ 11:59,500,500,1823,4493,80128130,6316,20231027,9-12,주간
12:00 ~ 14:59,1284,1284,7654,11884,626036990,19538,20231027,12-15,주간
15:00 ~ 17:59,1643,1643,9142,25672,1464717860,34814,20231027,15-18,주간
18:00 ~ 20:59,2693,2693,27848,59865,4403155260,87713,20231027,18-21,저녁
21:00 ~ 23:59,13,13,53,63,168800,116,20231027,21-24,저녁
합계,6137,6137,46520,102417,6574207040,148937,20231027,,
00:00 ~ 2:59,0,0,0,0,0,0,20231028,0-3,심야
3:00 ~ 5:59,0,0,0,0,0,0,20231028,3-6,심야
6:00 ~ 8:59,0,0,0,0,0,0,20231028,6-9,심야
9:00 ~ 11:59,486,486,1186,2006,55240790,3192,20231028,9-12,주간
12:00 ~ 14:59,1224,1224,6874,7924,471445520,14798,20231028,12-15,주간
15:00 ~ 17:59,1498,1498,7669,11535,602147370,19204,20231028,15-18,주간
18:00 ~ 20:59,2348,2348,19037,15446,1377781430,34483,20231028,18-21,저녁
21:00 ~ 23:59,20,20,27,84,4439100,111,20231028,21-24,저녁
합계,5576,5576,34793,36995,2511054210,71788,20231028,,
00:00 ~ 2:59,0,0,0,0,0,0,20231029,0-3,심야
3:00 ~ 5:59,0,0,0,0,0,0,20231029,3-6,심야
6:00 ~ 8:59,0,0,0,0,0,0,20231029,6-9,심야
9:00 ~ 11:59,427,427,765,1993,49382610,2758,20231029,9-12,주간
12:00 ~ 14:59,1150,1150,5304,7482,469167830,12786,20231029,12-15,주간
15:00 ~ 17:59,1385,1385,7058,7349,539705450,14407,20231029,15-18,주간
18:00 ~ 20:59,2308,2308,11952,14416,1161341740,26368,20231029,18-21,저녁
21:00 ~ 23:59,15,15,36,75,6829400,111,20231029,21-24,저녁
합계,5285,5285,25115,31315,2226427030,56430,20231029,,
00:00 ~ 2:59,0,0,0,0,0,0,20231030,0-3,심야
3:00 ~ 5:59,0,0,0,0,0,0,20231030,3-6,심야
6:00 ~ 8:59,0,0,0,0,0,0,20231030,6-9,심야
9:00 ~ 11:59,472,472,1150,2120,50816370,3270,20231030,9-12,주간
12:00 ~ 14:59,1166,1166,5439,9883,617676220,15322,20231030,12-15,주간
15:00 ~ 17:59,1490,1490,6918,15376,1250681410,22294,20231030,15-18,주간
18:00 ~ 20:59,2583,2583,20110,41552,2486392290,61662,20231030,18-21,저녁
21:00 ~ 23:59,19,19,43,64,3233100,107,20231030,21-24,저녁
합계,5730,5730,33660,68995,4408799390,102655,20231030,,
00:00 ~ 2:59,0,0,0,0,0,0,20231031,0-3,심야
3:00 ~ 5:59,0,0,0,0,0,0,20231031,3-6,심야
6:00 ~ 8:59,0,0,0,0,0,0,20231031,6-9,심야
9:00 ~ 11:59,481,481,1499,2460,57754440,3959,20231031,9-12,주간
12:00 ~ 14:59,1175,1175,5350,9867,635505140,15217,20231031,12-15,주간
15:00 ~ 17:59,1540,1540,8738,34082,3460420370,42820,20231031,15-18,주간
18:00 ~ 20:59,2668,2668,24146,47445,3377005210,71591,20231031,18-21,저녁
21:00 ~ 23:59,28,28,691,1089,130133200,1780,20231031,21-24,저녁
합계,5892,5892,40424,94943,7660818360,135367,20231031,,
00:00 ~ 2:59,0,0,0,0,0,0,20231101,0-3,심야
3:00 ~ 5:59,2,2,4,2,0,6,20231101,3-6,심야
6:00 ~ 8:59,0,0,0,0,0,0,20231101,6-9,심야
9:00 ~ 11:59,525,525,1543,3826,66298000,5369,20231101,9-12,주간
12:00 ~ 14:59,1280,1280,5413,11558,786509830,16971,20231101,12-15,주간
15:00 ~ 17:59,1703,1703,14770,37853,4225610060,52623,20231101,15-18,주간
18:00 ~ 20:59,2752,2752,26679,50197,4906508330,76876,20231101,18-21,저녁
21:00 ~ 23:59,23,23,118,119,8302300,237,20231101,21-24,저녁
합계,6285,6285,48527,103555,9993228520,152082,20231101,,
00:00 ~ 2:59,0,0,0,0,0,0,20231102,0-3,심야
3:00 ~ 5:59,1,1,5,0,0,5,20231102,3-6,심야
6:00 ~ 8:59,0,0,0,0,0,0,20231102,6-9,심야
9:00 ~ 11:59,549,549,2348,5161,97935960,7509,20231102,9-12,주간
12:00 ~ 14:59,1311,1311,7827,13811,1093496500,21638,20231102,12-15,주간
15:00 ~ 17:59,1667,1667,13952,22543,1811047320,36495,20231102,15-18,주간
18:00 ~ 20:59,2719,2719,28223,63344,6416280020,91567,20231102,18-21,저녁
21:00 ~ 23:59,28,28,54,141,3685300,195,20231102,21-24,저녁
합계,6275,6275,52409,105000,9422445100,157409,20231102,,
00:00 ~ 2:59,0,0,0,0,0,0,20231103,0-3,심야
3:00 ~ 5:59,1,1,4,0,0,4,20231103,3-6,심야
6:00 ~ 8:59,0,0,0,0,0,0,20231103,6-9,심야
9:00 ~ 11:59,554,554,2017,4793,83293750,6810,20231103,9-12,주간
12:00 ~ 14:59,1365,1365,6210,15300,679489682,21510,20231103,12-15,주간
15:00 ~ 17:59,1700,1700,11557,21451,1230225230,33008,20231103,15-18,주간
18:00 ~ 20:59,2675,2675,21833,38410,2450037140,60243,20231103,18-21,저녁
21:00 ~ 23:59,23,23,335,877,109741800,1212,20231103,21-24,저녁
합계,6318,6318,41956,80831,4552787602,122787,20231103,,
00:00 ~ 2:59,0,0,0,0,0,0,20231104,0-3,심야
3:00 ~ 5:59,0,0,0,0,0,0,20231104,3-6,심야
6:00 ~ 8:59,0,0,0,0,0,0,20231104,6-9,심야
9:00 ~ 11:59,471,471,855,2849,62649890,3704,20231104,9-12,주간
12:00 ~ 14:59,1304,1304,4991,8808,507502160,13799,20231104,12-15,주간
15:00 ~ 17:59,1569,1569,8834,16472,923379632,25306,20231104,15-18,주간
18:00 ~ 20:59,2335,2335,14302,18688,1359428960,32990,20231104,18-21,저녁
21:00 ~ 23:59,15,15,165,210,23214550,375,20231104,21-24,저녁
합계,5694,5694,29147,47027,2876175192,76174,20231104,,
00:00 ~ 2:59,0,0,0,0,0,0,20231105,0-3,심야
3:00 ~ 5:59,0,0,0,0,0,0,20231105,3-6,심야
6:00 ~ 8:59,0,0,0,0,0,0,20231105,6-9,심야
9:00 ~ 11:59,459,459,712,2086,56041530,2798,20231105,9-12,주간
12:00 ~ 14:59,1227,1227,4828,7959,471999920,12787,20231105,12-15,주간
15:00 ~ 17:59,1500,1500,7655,10365,626943640,18020,20231105,15-18,주간
18:00 ~ 20:59,2271,2271,13335,13820,1083102000,27155,20231105,18-21,저녁
21:00 ~ 23:59,19,19,82,121,13346300,203,20231105,21-24,저녁
합계,5476,5476,26612,34351,2251433390,60963,20231105,,
00:00 ~ 2:59,0,0,0,0,0,0,20231106,0-3,심야
3:00 ~ 5:59,0,0,0,0,0,0,20231106,3-6,심야
6:00 ~ 8:59,0,0,0,0,0,0,20231106,6-9,심야
9:00 ~ 11:59,501,501,995,2387,60228970,3382,20231106,9-12,주간
12:00 ~ 14:59,1255,1255,6859,9806,638147022,16665,20231106,12-15,주간
15:00 ~ 17:59,1557,1557,9308,17838,1111842240,27146,20231106,15-18,주간
18:00 ~ 20:59,2619,2619,20968,28576,1504137900,49544,20231106,18-21,저녁
21:00 ~ 23:59,19,19,91,106,8420800,197,20231106,21-24,저녁
합계,5951,5951,38221,58713,3322776932,96934,20231106,,
00:00 ~ 2:59,0,0,0,0,0,0,20231107,0-3,심야
3:00 ~ 5:59,0,0,0,0,0,0,20231107,3-6,심야
6:00 ~ 8:59,0,0,0,0,0,0,20231107,6-9,심야
9:00 ~ 11:59,526,526,1406,3767,92812190,5173,20231107,9-12,주간
12:00 ~ 14:59,1279,1279,5399,16395,604945172,21794,20231107,12-15,주간
15:00 ~ 17:59,1560,1560,9615,26144,2646245772,35759,20231107,15-18,주간
18:00 ~ 20:59,2756,2756,20243,45276,2040248502,65519,20231107,18-21,저녁
21:00 ~ 23:59,21,21,296,1642,244689400,1938,20231107,21-24,저녁
합계,6142,6142,36959,93224,5628941036,130183,20231107,,
00:00 ~ 2:59,0,0,0,0,0,0,20231108,0-3,심야
3:00 ~ 5:59,0,0,0,0,0,0,20231108,3-6,심야
6:00 ~ 8:59,0,0,0,0,0,0,20231108,6-9,심야
9:00 ~ 11:59,554,554,1818,5922,82602720,7740,20231108,9-12,주간
12:00 ~ 14:59,1328,1328,6461,11777,678415622,18238,20231108,12-15,주간
15:00 ~ 17:59,1653,1653,11791,20581,1208295860,32372,20231108,15-18,주간
18:00 ~ 20:59,2720,2720,25424,36874,2522031492,62298,20231108,18-21,저녁
21:00 ~ 23:59,26,26,243,185,20527100,428,20231108,21-24,저녁
합계,6281,6281,45737,75339,4511872794,121076,20231108,,
00:00 ~ 2:59,0,0,0,0,0,0,20231109,0-3,심야
3:00 ~ 5:59,0,0,0,0,0,0,20231109,3-6,심야
6:00 ~ 8:59,0,0,0,0,0,0,20231109,6-9,심야
9:00 ~ 11:59,534,534,2525,5378,51884700,7903,20231109,9-12,주간
12:00 ~ 14:59,1305,1305,6894,14238,627410594,21132,20231109,12-15,주간
15:00 ~ 17:59,1672,1672,13528,22177,1565355672,35705,20231109,15-18,주간
18:00 ~ 20:59,2782,2782,22747,42744,1853387304,65491,20231109,18-21,저녁
21:00 ~ 23:59,22,22,119,144,11772200,263,20231109,21-24,저녁
합계,6315,6315,45813,84681,4109810470,130494,20231109,,
00:00 ~ 2:59,0,0,0,0,0,0,20231110,0-3,심야
3:00 ~ 5:59,0,0,0,0,0,0,20231110,3-6,심야
6:00 ~ 8:59,0,0,0,0,0,0,20231110,6-9,심야
9:00 ~ 11:59,617,617,1647,5139,97027620,6786,20231110,9-12,주간
12:00 ~ 14:59,1439,1439,7817,17708,1185991522,25525,20231110,12-15,주간
15:00 ~ 17:59,1805,1805,12340,22313,1129327062,34653,20231110,15-18,주간
18:00 ~ 20:59,2774,2774,19870,58335,5347678664,78205,20231110,18-21,저녁
21:00 ~ 23:59,20,20,363,10576,1430867700,10939,20231110,21-24,저녁
합계,6655,6655,42037,114071,9190892568,156108,20231110,,
00:00 ~ 2:59,0,0,0,0,0,0,20231111,0-3,심야
3:00 ~ 5:59,0,0,0,0,0,0,20231111,3-6,심야
6:00 ~ 8:59,0,0,0,0,0,0,20231111,6-9,심야
9:00 ~ 11:59,536,536,1631,2501,65528290,4132,20231111,9-12,주간
12:00 ~ 14:59,1378,1378,6395,9777,522851934,16172,20231111,12-15,주간
15:00 ~ 17:59,1649,1649,8347,12856,683523221,21203,20231111,15-18,주간
18:00 ~ 20:59,2459,2459,12654,18655,1469948468,31309,20231111,18-21,저녁
21:00 ~ 23:59,15,15,510,1134,147681900,1644,20231111,21-24,저녁
합계,6037,6037,29537,44923,2889533813,74460,20231111,,
00:00 ~ 2:59,0,0,0,0,0,0,20231112,0-3,심야
3:00 ~ 5:59,0,0,0,0,0,0,20231112,3-6,심야
6:00 ~ 8:59,0,0,0,0,0,0,20231112,6-9,심야
9:00 ~ 11:59,510,510,1041,2537,58978520,3578,20231112,9-12,주간
12:00 ~ 14:59,1306,1306,6330,8539,502626579,14869,20231112,12-15,주간
15:00 ~ 17:59,1553,1553,6827,10747,583678164,17574,20231112,15-18,주간
18:00 ~ 20:59,2412,2412,11936,13769,1017792884,25705,20231112,18-21,저녁
21:00 ~ 23:59,23,23,372,263,32768600,635,20231112,21-24,저녁
합계,5804,5804,26506,35855,2195844747,62361,20231112,,
00:00 ~ 2:59,0,0,0,0,0,0,20231113,0-3,심야
3:00 ~ 5:59,0,0,0,0,0,0,20231113,3-6,심야
6:00 ~ 8:59,0,0,0,0,0,0,20231113,6-9,심야
9:00 ~ 11:59,536,536,1261,3418,56723710,4679,20231113,9-12,주간
12:00 ~ 14:59,1276,1276,4790,8842,489942100,13632,20231113,12-15,주간
15:00 ~ 17:59,1596,1596,7882,18330,1172318983,26212,20231113,15-18,주간
18:00 ~ 20:59,2638,2638,20013,27105,2167383605,47118,20231113,18-21,저녁
21:00 ~ 23:59,15,15,371,113,6437000,484,20231113,21-24,저녁
합계,6061,6061,34317,57808,3892805398,92125,20231113,,
00:00 ~ 2:59,0,0,0,0,0,0,20231114,0-3,심야
3:00 ~ 5:59,0,0,0,0,0,0,20231114,3-6,심야
6:00 ~ 8:59,0,0,0,0,0,0,20231114,6-9,심야
9:00 ~ 11:59,580,580,2504,4287,75639710,6791,20231114,9-12,주간
12:00 ~ 14:59,1342,1342,6675,14084,800870482,20759,20231114,12-15,주간
15:00 ~ 17:59,1738,1738,8000,16374,1009841910,24374,20231114,15-18,주간
18:00 ~ 20:59,2851,2851,20862,44752,2264322494,65614,20231114,18-21,저녁
21:00 ~ 23:59,19,19,222,167,16642600,389,20231114,21-24,저녁
합계,6530,6530,38263,79664,4167317196,117927,20231114,,
00:00 ~ 2:59,0,0,0,0,0,0,20231115,0-3,심야
3:00 ~ 5:59,0,0,0,0,0,0,20231115,3-6,심야
6:00 ~ 8:59,0,0,0,0,0,0,20231115,6-9,심야
9:00 ~ 11:59,619,619,2293,5476,91358610,7769,20231115,9-12,주간
12:00 ~ 14:59,1424,1424,7770,16229,938743620,23999,20231115,12-15,주간
15:00 ~ 17:59,1779,1779,9387,21819,956947152,31206,20231115,15-18,주간
18:00 ~ 20:59,2851,2851,23111,50254,2752681828,73365,20231115,18-21,저녁
21:00 ~ 23:59,24,24,165,483,31676800,648,20231115,21-24,저녁
합계,6697,6697,42726,94261,4771408010,136987,20231115,,
00:00 ~ 2:59,0,0,0,0,0,0,20231116,0-3,심야
3:00 ~ 5:59,1,1,0,1,10000,1,20231116,3-6,심야
6:00 ~ 8:59,0,0,0,0,0,0,20231116,6-9,심야
9:00 ~ 11:59,605,605,2575,4926,99375320,7501,20231116,9-12,주간
12:00 ~ 14:59,1433,1433,11039,16237,1028733730,27276,20231116,12-15,주간
15:00 ~ 17:59,1847,1847,8326,18231,736871228,26557,20231116,15-18,주간
18:00 ~ 20:59,2873,2873,26671,64301,5755583255,90972,20231116,18-21,저녁
21:00 ~ 23:59,22,22,283,1844,68272300,2127,20231116,21-24,저녁
합계,6781,6781,48894,105540,7688845833,154434,20231116,,
00:00 ~ 2:59,2,2,0,2,20000,2,20231117,0-3,심야
3:00 ~ 5:59,0,0,0,0,0,0,20231117,3-6,심야
6:00 ~ 8:59,0,0,0,0,0,0,20231117,6-9,심야
9:00 ~ 11:59,643,643,3035,4775,88908400,7810,20231117,9-12,주간
12:00 ~ 14:59,1510,1510,7681,15471,909424280,23152,20231117,12-15,주간
15:00 ~ 17:59,1855,1855,9907,27694,1891151840,37601,20231117,15-18,주간
18:00 ~ 20:59,2853,2853,21642,41315,2636661326,62957,20231117,18-21,저녁
21:00 ~ 23:59,17,17,246,262,16687300,508,20231117,21-24,저녁
합계,6880,6880,42511,89519,5542853146,132030,20231117,,
00:00 ~ 2:59,0,0,0,0,0,0,20231118,0-3,심야
3:00 ~ 5:59,0,0,0,0,0,0,20231118,3-6,심야
6:00 ~ 8:59,0,0,0,0,0,0,20231118,6-9,심야
9:00 ~ 11:59,577,577,1397,2669,62264370,4066,20231118,9-12,주간
12:00 ~ 14:59,1430,1430,7535,8936,566701970,16471,20231118,12-15,주간
15:00 ~ 17:59,1743,1743,7864,14913,776974043,22777,20231118,15-18,주간
18:00 ~ 20:59,2514,2514,13290,17504,1332475252,30794,20231118,18-21,저녁
21:00 ~ 23:59,20,20,155,171,13299000,326,20231118,21-24,저녁
합계,6284,6284,30241,44193,2751714635,74434,20231118,,
00:00 ~ 2:59,0,0,0,0,0,0,20231119,0-3,심야
3:00 ~ 5:59,0,0,0,0,0,0,20231119,3-6,심야
6:00 ~ 8:59,0,0,0,0,0,0,20231119,6-9,심야
9:00 ~ 11:59,534,534,1052,3322,95862120,4374,20231119,9-12,주간
12:00 ~ 14:59,1388,1388,6459,8390,460753502,14849,20231119,12-15,주간
15:00 ~ 17:59,1664,1664,6486,12836,695569302,19322,20231119,15-18,주간
18:00 ~ 20:59,2446,2446,10375,16276,1187674751,26651,20231119,18-21,저녁
21:00 ~ 23:59,26,26,203,300,15366250,503,20231119,21-24,저녁
합계,6058,6058,24575,41124,2455225925,65699,20231119,,
00:00 ~ 2:59,0,0,0,0,0,0,20231120,0-3,심야
3:00 ~ 5:59,0,0,0,0,0,0,20231120,3-6,심야
6:00 ~ 8:59,0,0,0,0,0,0,20231120,6-9,심야
9:00 ~ 11:59,576,576,1344,3412,76564490,4756,20231120,9-12,주간
12:00 ~ 14:59,1391,1391,5817,9997,611956641,15814,20231120,12-15,주간
15:00 ~ 17:59,1768,1768,9676,17450,1285329342,27126,20231120,15-18,주간
18:00 ~ 20:59,2920,2920,21325,38512,3403127554,59837,20231120,18-21,저녁
21:00 ~ 23:59,25,25,430,415,24195750,845,20231120,21-24,저녁
합계,6680,6680,38592,69786,5401173777,108378,20231120,,
00:00 ~ 2:59,0,0,0,0,0,0,20231121,0-3,심야
3:00 ~ 5:59,0,0,0,0,0,0,20231121,3-6,심야
6:00 ~ 8:59,0,0,0,0,0,0,20231121,6-9,심야
9:00 ~ 11:59,638,638,1920,5251,96491650,7171,20231121,9-12,주간
12:00 ~ 14:59,1454,1454,9910,27042,2362337326,36952,20231121,12-15,주간
15:00 ~ 17:59,1814,1814,13829,29152,2639527230,42981,20231121,15-18,주간
18:00 ~ 20:59,3023,3023,26615,69438,4587395796,96053,20231121,18-21,저녁
21:00 ~ 23:59,31,31,2209,29068,4404040100,31277,20231121,21-24,저녁
합계,6960,6960,54483,159951,14089792102,214434,20231121,,
00:00 ~ 2:59,0,0,0,0,0,0,20231122,0-3,심야
3:00 ~ 5:59,0,0,0,0,0,0,20231122,3-6,심야
6:00 ~ 8:59,0,0,0,0,0,0,20231122,6-9,심야
9:00 ~ 11:59,685,685,2559,6125,129803580,8684,20231122,9-12,주간
12:00 ~ 14:59,1550,1550,9972,22296,1526204936,32268,20231122,12-15,주간
15:00 ~ 17:59,1846,1846,27006,46511,5011576564,73517,20231122,15-18,주간
18:00 ~ 20:59,3005,3005,27568,49861,3034897507,77429,20231122,18-21,저녁
21:00 ~ 23:59,28,28,1789,3875,561392550,5664,20231122,21-24,저녁
합계,7114,7114,68894,128668,10263875137,197562,20231122,,
00:00 ~ 2:59,0,0,0,0,0,0,20231123,0-3,심야
3:00 ~ 5:59,0,0,0,0,0,0,20231123,3-6,심야
6:00 ~ 8:59,0,0,0,0,0,0,20231123,6-9,심야
9:00 ~ 11:59,688,688,3004,5989,100947050,8993,20231123,9-12,주간
12:00 ~ 14:59,1587,1587,12617,19118,1328991002,31735,20231123,12-15,주간
15:00 ~ 17:59,1955,1955,15500,21603,1212180121,37103,20231123,15-18,주간
18:00 ~ 20:59,2968,2968,26762,41484,2605974653,68246,20231123,18-21,저녁
21:00 ~ 23:59,27,27,1109,1601,225952650,2710,20231123,21-24,저녁
합계,7225,7225,58992,89795,5474045476,148787,20231123,,
00:00 ~ 2:59,0,0,0,0,0,0,20231124,0-3,심야
3:00 ~ 5:59,0,0,0,0,0,0,20231124,3-6,심야
6:00 ~ 8:59,0,0,0,0,0,0,20231124,6-9,심야
9:00 ~ 11:59,704,704,2694,4868,93628350,7562,20231124,9-12,주간
12:00 ~ 14:59,1602,1602,8260,13810,825761090,22070,20231124,12-15,주간
15:00 ~ 17:59,1945,1945,13684,21415,1333376530,35099,20231124,15-18,주간
18:00 ~ 20:59,2934,2934,22971,34535,2479253244,57506,20231124,18-21,저녁
21:00 ~ 23:59,37,37,1054,1669,210536600,2723,20231124,21-24,저녁
합계,7222,7222,48663,76297,4942555814,124960,20231124,,
00:00 ~ 2:59,0,0,0,0,0,0,20231125,0-3,심야
3:00 ~ 5:59,0,0,0,0,0,0,20231125,3-6,심야
6:00 ~ 8:59,0,0,0,0,0,0,20231125,6-9,심야
9:00 ~ 11:59,601,601,1339,3068,71336060,4407,20231125,9-12,주간
12:00 ~ 14:59,1546,1546,7781,10915,647118779,18696,20231125,12-15,주간
15:00 ~ 17:59,1800,1800,9401,13792,817654978,23193,20231125,15-18,주간
18:00 ~ 20:59,2593,2593,15399,16062,1400022577,31461,20231125,18-21,저녁
21:00 ~ 23:59,41,41,1005,547,61726950,1552,20231125,21-24,저녁
합계,6581,6581,34925,44384,2997859344,79309,20231125,,
00:00 ~ 2:59,0,0,0,0,0,0,20231126,0-3,심야
3:00 ~ 5:59,0,0,0,0,0,0,20231126,3-6,심야
6:00 ~ 8:59,0,0,0,0,0,0,20231126,6-9,심야
9:00 ~ 11:59,624,624,1192,3078,71122280,4270,20231126,9-12,주간
12:00 ~ 14:59,1511,1511,6594,10265,627536800,16859,20231126,12-15,주간
15:00 ~ 17:59,1721,1721,8919,10591,740009062,19510,20231126,15-18,주간
18:00 ~ 20:59,2581,2581,11732,15900,1183480302,27632,20231126,18-21,저녁
21:00 ~ 23:59,48,48,975,286,25707900,1261,20231126,21-24,저녁
합계,6485,6485,29412,40120,2647856344,69532,20231126,,
00:00 ~ 2:59,1,1,1,-1,-10000,0,20231127,0-3,심야
3:00 ~ 5:59,0,0,0,0,0,0,20231127,3-6,심야
6:00 ~ 8:59,0,0,0,0,0,0,20231127,6-9,심야
9:00 ~ 11:59,658,658,1738,5082,84662240,6820,20231127,9-12,주간
12:00 ~ 14:59,1507,1507,6988,14502,782935580,21490,20231127,12-15,주간
15:00 ~ 17:59,1799,1799,9137,15098,630766800,24235,20231127,15-18,주간
18:00 ~ 20:59,2911,2911,19177,39826,1750092106,59003,20231127,18-21,저녁
21:00 ~ 23:59,62,62,1348,85,-13178300,1433,20231127,21-24,저녁
합계,6938,6938,38389,74592,3235268426,112981,20231127,,
00:00 ~ 2:59,0,0,0,0,0,0,20231128,0-3,심야
3:00 ~ 5:59,0,0,0,0,0,0,20231128,3-6,심야
6:00 ~ 8:59,0,0,0,0,0,0,20231128,6-9,심야
9:00 ~ 11:59,664,664,2804,6747,99532370,9551,20231128,9-12,주간
12:00 ~ 14:59,1557,1557,7114,15265,682056852,22379,20231128,12-15,주간
15:00 ~ 17:59,1897,1897,10588,21473,884371030,32061,20231128,15-18,주간
18:00 ~ 20:59,3063,3063,21153,36503,1557588220,57656,20231128,18-21,저녁
21:00 ~ 23:59,49,49,2199,624,9228250,2823,20231128,21-24,저녁
합계,7230,7230,43858,80612,3232776722,124470,20231128,,
00:00 ~ 2:59,1,1,1,-1,-10000,0,20231129,0-3,심야
3:00 ~ 5:59,0,0,0,0,0,0,20231129,3-6,심야
6:00 ~ 8:59,0,0,0,0,0,0,20231129,6-9,심야
9:00 ~ 11:59,708,708,2974,4720,89504570,7694,20231129,9-12,주간
12:00 ~ 14:59,1633,1633,7031,13133,657165230,20164,20231129,12-15,주간
15:00 ~ 17:59,1918,1918,11906,17895,881211340,29801,20231129,15-18,주간
18:00 ~ 20:59,3096,3096,24969,38013,2161416962,62982,20231129,18-21,저녁
21:00 ~ 23:59,55,55,861,903,104392800,1764,20231129,21-24,저녁
합계,7411,7411,47742,74663,3893680902,122405,20231129,,
00:00 ~ 2:59,0,0,0,0,0,0,20231130,0-3,심야
3:00 ~ 5:59,2,2,2,-2,-20000,0,20231130,3-6,심야
6:00 ~ 8:59,0,0,0,0,0,0,20231130,6-9,심야
9:00 ~ 11:59,706,706,3441,5947,93452710,9388,20231130,9-12,주간
12:00 ~ 14:59,1645,1645,7342,11863,614112980,19205,20231130,12-15,주간
15:00 ~ 17:59,1958,1958,9034,15648,642121160,24682,20231130,15-18,주간
18:00 ~ 20:59,3053,3053,21988,36257,1398437386,58245,20231130,18-21,저녁
21:00 ~ 23:59,57,57,494,796,100325050,1290,20231130,21-24,저녁
합계,7421,7421,42301,70509,2848429286,112810,20231130,,
00:00 ~ 2:59,2,2,1,0,0,1,20231201,0-3,심야
3:00 ~ 5:59,1,1,1,-1,-10000,0,20231201,3-6,심야
6:00 ~ 8:59,0,0,0,0,0,0,20231201,6-9,심야
9:00 ~ 11:59,747,747,4033,3329,85744030,7362,20231201,9-12,주간
12:00 ~ 14:59,1753,1753,7997,15936,735115272,23933,20231201,12-15,주간
15:00 ~ 17:59,2103,2103,18749,29887,1830772410,48636,20231201,15-18,주간
18:00 ~ 20:59,3047,3047,24865,38787,1717143980,63652,20231201,18-21,저녁
21:00 ~ 23:59,56,56,432,615,76912400,1047,20231201,21-24,저녁
합계,7709,7709,56078,88553,4445678092,144631,20231201,,
00:00 ~ 2:59,1,1,0,1,10000,1,20231202,0-3,심야
3:00 ~ 5:59,0,0,0,0,0,0,20231202,3-6,심야
6:00 ~ 8:59,0,0,0,0,0,0,20231202,6-9,심야
9:00 ~ 11:59,642,642,1578,2952,70888340,4530,20231202,9-12,주간
12:00 ~ 14:59,1703,1703,7118,12492,636196502,19610,20231202,12-15,주간
15:00 ~ 17:59,1973,1973,10374,19150,868804000,29524,20231202,15-18,주간
18:00 ~ 20:59,2648,2648,16269,16884,1313505620,33153,20231202,18-21,저녁
21:00 ~ 23:59,61,61,268,349,26355500,617,20231202,21-24,저녁
합계,7028,7028,35607,51828,2915759962,87435,20231202,,
00:00 ~ 2:59,1,1,1,-1,-10000,0,20231203,0-3,심야
3:00 ~ 5:59,0,0,0,0,0,0,20231203,3-6,심야
6:00 ~ 8:59,0,0,0,0,0,0,20231203,6-9,심야
9:00 ~ 11:59,631,631,1054,3297,75936490,4351,20231203,9-12,주간
12:00 ~ 14:59,1626,1626,6053,11564,630838482,17617,20231203,12-15,주간
15:00 ~ 17:59,1889,1889,8577,12725,766563670,21302,20231203,15-18,주간
18:00 ~ 20:59,2585,2585,11441,16577,1201268910,28018,20231203,18-21,저녁
21:00 ~ 23:59,69,69,239,377,31833050,616,20231203,21-24,저녁
합계,6801,6801,27365,44539,2706430602,71904,20231203,,
00:00 ~ 2:59,0,0,0,0,0,0,20231204,0-3,심야
3:00 ~ 5:59,0,0,0,0,0,0,20231204,3-6,심야
6:00 ~ 8:59,0,0,0,0,0,0,20231204,6-9,심야
9:00 ~ 11:59,696,696,1923,4273,92026580,6196,20231204,9-12,주간
12:00 ~ 14:59,1644,1644,6381,17621,788976070,24002,20231204,12-15,주간
15:00 ~ 17:59,1907,1907,13865,21005,1893046270,34870,20231204,15-18,주간
18:00 ~ 20:59,2980,2980,23101,37264,1688172758,60365,20231204,18-21,저녁
21:00 ~ 23:59,62,62,391,1123,50570680,1514,20231204,21-24,저녁
합계,7289,7289,45661,81286,4512792358,126947,20231204,,
00:00 ~ 2:59,0,0,0,0,0,0,20231205,0-3,심야
3:00 ~ 5:59,1,1,0,1,10000,1,20231205,3-6,심야
6:00 ~ 8:59,0,0,0,0,0,0,20231205,6-9,심야
9:00 ~ 11:59,708,708,3408,3659,89635990,7067,20231205,9-12,주간
12:00 ~ 14:59,1631,1631,22934,11995,706734530,34929,20231205,12-15,주간
15:00 ~ 17:59,1921,1921,11719,15559,1175498160,27278,20231205,15-18,주간
18:00 ~ 20:59,3002,3002,25200,33867,2258866812,59067,20231205,18-21,저녁
21:00 ~ 23:59,69,69,357,245,14988900,602,20231205,21-24,저녁
합계,7332,7332,63618,65326,4245734392,128944,20231205,,
00:00 ~ 2:59,0,0,0,0,0,0,20231206,0-3,심야
3:00 ~ 5:59,0,0,0,0,0,0,20231206,3-6,심야
6:00 ~ 8:59,0,0,0,0,0,0,20231206,6-9,심야
9:00 ~ 11:59,717,717,1955,3893,104322610,5848,20231206,9-12,주간
12:00 ~ 14:59,1687,1687,8596,14220,969387270,22816,20231206,12-15,주간
15:00 ~ 17:59,1997,1997,10854,17178,818716460,28032,20231206,15-18,주간
18:00 ~ 20:59,3042,3042,25919,41465,2277435620,67384,20231206,18-21,저녁
21:00 ~ 23:59,55,55,349,294,20313200,643,20231206,21-24,저녁
합계,7498,7498,47673,77050,4190175160,124723,20231206,,
00:00 ~ 2:59,0,0,0,0,0,0,20231207,0-3,심야
3:00 ~ 5:59,0,0,0,0,0,0,20231207,3-6,심야
6:00 ~ 8:59,0,0,0,0,0,0,20231207,6-9,심야
9:00 ~ 11:59,704,704,1813,4766,84087520,6579,20231207,9-12,주간
12:00 ~ 14:59,1698,1698,7601,14317,728949742,21918,20231207,12-15,주간
15:00 ~ 17:59,2051,2051,10602,22593,1172675840,33195,20231207,15-18,주간
18:00 ~ 20:59,3056,3056,23591,44827,2702787503,68418,20231207,18-21,저녁
21:00 ~ 23:59,59,59,359,876,26368100,1235,20231207,21-24,저녁
합계,7568,7568,43966,87379,4714868705,131345,20231207,,
00:00 ~ 2:59,0,0,0,0,0,0,20231208,0-3,심야
3:00 ~ 5:59,0,0,0,0,0,0,20231208,3-6,심야
6:00 ~ 8:59,0,0,0,0,0,0,20231208,6-9,심야
9:00 ~ 11:59,763,763,3538,5223,115868560,8761,20231208,9-12,주간
12:00 ~ 14:59,1754,1754,9225,18906,1022744720,28131,20231208,12-15,주간
15:00 ~ 17:59,2116,2116,10444,19479,824811690,29923,20231208,15-18,주간
18:00 ~ 20:59,3015,3015,23015,38752,2393041374,61767,20231208,18-21,저녁
21:00 ~ 23:59,62,62,433,591,23919100,1024,20231208,21-24,저녁
합계,7710,7710,46655,82951,4380385444,129606,20231208,,
00:00 ~ 2:59,0,0,0,0,0,0,20231209,0-3,심야
3:00 ~ 5:59,0,0,0,0,0,0,20231209,3-6,심야
6:00 ~ 8:59,0,0,0,0,0,0,20231209,6-9,심야
9:00 ~ 11:59,696,696,1430,3342,82081670,4772,20231209,9-12,주간
12:00 ~ 14:59,1712,1712,11208,7103,623528890,18311,20231209,12-15,주간
15:00 ~ 17:59,1964,1964,10173,14935,768789820,25108,20231209,15-18,주간
18:00 ~ 20:59,2747,2747,16644,19458,1380822642,36102,20231209,18-21,저녁
21:00 ~ 23:59,60,60,291,385,37166700,676,20231209,21-24,저녁
합계,7179,7179,39746,45223,2892389722,84969,20231209,,
00:00 ~ 2:59,0,0,0,0,0,0,20231210,0-3,심야
3:00 ~ 5:59,0,0,0,0,0,0,20231210,3-6,심야
6:00 ~ 8:59,0,0,0,0,0,0,20231210,6-9,심야
9:00 ~ 11:59,700,700,1302,3281,78170610,4583,20231210,9-12,주간
12:00 ~ 14:59,1686,1686,10765,7115,601540960,17880,20231210,12-15,주간
15:00 ~ 17:59,1882,1882,7799,12881,712270540,20680,20231210,15-18,주간
18:00 ~ 20:59,2648,2648,13353,16555,1242459602,29908,20231210,18-21,저녁
21:00 ~ 23:59,57,57,277,428,25838100,705,20231210,21-24,저녁
합계,6973,6973,33496,40260,2660279812,73756,20231210,,
00:00 ~ 2:59,0,0,0,0,0,0,20231211,0-3,심야
3:00 ~ 5:59,0,0,0,0,0,0,20231211,3-6,심야
6:00 ~ 8:59,0,0,0,0,0,0,20231211,6-9,심야
9:00 ~ 11:59,701,701,2117,3147,71721470,5264,20231211,9-12,주간
12:00 ~ 14:59,1636,1636,6592,10059,533141010,16651,20231211,12-15,주간
15:00 ~ 17:59,1847,1847,9147,11092,612806720,20239,20231211,15-18,주간
18:00 ~ 20:59,2958,2958,18878,25705,1306923912,44583,20231211,18-21,저녁
21:00 ~ 23:59,59,59,399,253,18375250,652,20231211,21-24,저녁
합계,7201,7201,37133,50256,2542968362,87389,20231211,,
00:00 ~ 2:59,0,0,0,0,0,0,20231212,0-3,심야
3:00 ~ 5:59,0,0,0,0,0,0,20231212,3-6,심야
6:00 ~ 8:59,0,0,0,0,0,0,20231212,6-9,심야
9:00 ~ 11:59,708,708,2262,4033,77491310,6295,20231212,9-12,주간
12:00 ~ 14:59,1684,1684,8473,15830,799672084,24303,20231212,12-15,주간
15:00 ~ 17:59,1940,1940,9799,17486,1065661030,27285,20231212,15-18,주간
18:00 ~ 20:59,3029,3029,26787,35936,2345541470,62723,20231212,18-21,저녁
21:00 ~ 23:59,70,70,564,437,18056400,1001,20231212,21-24,저녁
합계,7431,7431,47885,73722,4306422294,121607,20231212,,
00:00 ~ 2:59,0,0,0,0,0,0,20231213,0-3,심야
3:00 ~ 5:59,0,0,0,0,0,0,20231213,3-6,심야
6:00 ~ 8:59,0,0,0,0,0,0,20231213,6-9,심야
9:00 ~ 11:59,749,749,2773,4087,83373210,6860,20231213,9-12,주간
12:00 ~ 14:59,1764,1764,8944,20026,685347252,28970,20231213,12-15,주간
15:00 ~ 17:59,1921,1921,9823,14489,678312980,24312,20231213,15-18,주간
18:00 ~ 20:59,3020,3020,22899,41795,2194545502,64694,20231213,18-21,저녁
21:00 ~ 23:59,64,64,394,369,15786100,763,20231213,21-24,저녁
합계,7518,7518,44833,80766,3657365044,125599,20231213,,
00:00 ~ 2:59,0,0,0,0,0,0,20231214,0-3,심야
3:00 ~ 5:59,0,0,0,0,0,0,20231214,3-6,심야
6:00 ~ 8:59,0,0,0,0,0,0,20231214,6-9,심야
9:00 ~ 11:59,756,756,2381,5026,85507800,7407,20231214,9-12,주간
12:00 ~ 14:59,1751,1751,9258,14842,1248699470,24100,20231214,12-15,주간
15:00 ~ 17:59,1961,1961,10310,15175,777974850,25485,20231214,15-18,주간
18:00 ~ 20:59,2986,2986,23318,61945,5697381828,85263,20231214,18-21,저녁
21:00 ~ 23:59,50,50,571,178,-1857200,749,20231214,21-24,저녁
합계,7504,7504,45838,97166,7807706748,143004,20231214,,
00:00 ~ 2:59,0,0,0,0,0,0,20231215,0-3,심야
3:00 ~ 5:59,0,0,0,0,0,0,20231215,3-6,심야
6:00 ~ 8:59,0,0,0,0,0,0,20231215,6-9,심야
9:00 ~ 11:59,765,765,3259,3977,83473040,7236,20231215,9-12,주간
12:00 ~ 14:59,1796,1796,9748,12944,644919028,22692,20231215,12-15,주간
15:00 ~ 17:59,2052,2052,11286,19263,1060473647,30549,20231215,15-18,주간
18:00 ~ 20:59,2936,2936,24589,42473,2069091313,67062,20231215,18-21,저녁
21:00 ~ 23:59,60,60,349,308,24546950,657,20231215,21-24,저녁
합계,7609,7609,49231,78965,3882503978,128196,20231215,,
00:00 ~ 2:59,0,0,0,0,0,0,20231216,0-3,심야
3:00 ~ 5:59,0,0,0,0,0,0,20231216,3-6,심야
6:00 ~ 8:59,0,0,0,0,0,0,20231216,6-9,심야
9:00 ~ 11:59,699,699,2027,4069,76576460,6096,20231216,9-12,주간
12:00 ~ 14:59,1740,1740,11213,8393,559961240,19606,20231216,12-15,주간
15:00 ~ 17:59,1995,1995,9910,14526,713156240,24436,20231216,15-18,주간
18:00 ~ 20:59,2578,2578,17897,14278,1254149614,32175,20231216,18-21,저녁
21:00 ~ 23:59,48,48,212,211,19517300,423,20231216,21-24,저녁
합계,7060,7060,41259,41477,2623360854,82736,20231216,,
00:00 ~ 2:59,0,0,0,0,0,0,20231217,0-3,심야
3:00 ~ 5:59,0,0,0,0,0,0,20231217,3-6,심야
6:00 ~ 8:59,0,0,0,0,0,0,20231217,6-9,심야
9:00 ~ 11:59,720,720,1549,3473,79804460,5022,20231217,9-12,주간
12:00 ~ 14:59,1671,1671,8463,9985,557445482,18448,20231217,12-15,주간
15:00 ~ 17:59,1835,1835,8007,16374,731890362,24381,20231217,15-18,주간
18:00 ~ 20:59,2537,2537,10851,16978,1108547150,27829,20231217,18-21,저녁
21:00 ~ 23:59,46,46,138,238,16405150,376,20231217,21-24,저녁
합계,6809,6809,29008,47048,2494092604,76056,20231217,,
00:00 ~ 2:59,0,0,0,0,0,0,20231218,0-3,심야
3:00 ~ 5:59,0,0,0,0,0,0,20231218,3-6,심야
6:00 ~ 8:59,0,0,0,0,0,0,20231218,6-9,심야
9:00 ~ 11:59,714,714,2395,3138,79740440,5533,20231218,9-12,주간
12:00 ~ 14:59,1657,1657,6824,13089,583212784,19913,20231218,12-15,주간
15:00 ~ 17:59,1757,1757,8517,20665,1354079290,29182,20231218,15-18,주간
18:00 ~ 20:59,2659,2659,22864,37408,2068735772,60272,20231218,18-21,저녁
21:00 ~ 23:59,56,56,283,239,12450200,522,20231218,21-24,저녁
합계,6843,6843,40883,74539,4098218486,115422,20231218,,
00:00 ~ 2:59,0,0,0,0,0,0,20231219,0-3,심야
3:00 ~ 5:59,1,1,0,44,0,44,20231219,3-6,심야
6:00 ~ 8:59,0,0,0,0,0,0,20231219,6-9,심야
9:00 ~ 11:59,830,830,2409,5588,164042780,7997,20231219,9-12,주간
12:00 ~ 14:59,1749,1749,9427,15791,1038513570,25218,20231219,12-15,주간
15:00 ~ 17:59,1811,1811,8992,15461,1045663408,24453,20231219,15-18,주간
18:00 ~ 20:59,2731,2731,26900,29824,2140886460,56724,20231219,18-21,저녁
21:00 ~ 23:59,56,56,419,305,15517150,724,20231219,21-24,저녁
합계,7178,7178,48147,67013,4404623368,115160,20231219,,
00:00 ~ 2:59,0,0,0,0,0,0,20231220,0-3,심야
3:00 ~ 5:59,1,1,0,12,0,12,20231220,3-6,심야
6:00 ~ 8:59,0,0,0,0,0,0,20231220,6-9,심야
9:00 ~ 11:59,813,813,3146,5675,112230300,8821,20231220,9-12,주간
12:00 ~ 14:59,1786,1786,9042,13414,720101310,22456,20231220,12-15,주간
15:00 ~ 17:59,1860,1860,11207,22707,1752438550,33914,20231220,15-18,주간
18:00 ~ 20:59,2806,2806,26990,38848,1858499950,65838,20231220,18-21,저녁
21:00 ~ 23:59,56,56,706,407,11260500,1113,20231220,21-24,저녁
합계,7322,7322,51091,81063,4454530610,132154,20231220,,
00:00 ~ 2:59,0,0,0,0,0,0,20231221,0-3,심야
3:00 ~ 5:59,1,1,0,24,0,24,20231221,3-6,심야
6:00 ~ 8:59,0,0,0,0,0,0,20231221,6-9,심야
9:00 ~ 11:59,828,828,3264,6709,114220250,9973,20231221,9-12,주간
12:00 ~ 14:59,1806,1806,36381,16853,863950510,53234,20231221,12-15,주간
15:00 ~ 17:59,1839,1839,9824,19077,1223325420,28901,20231221,15-18,주간
18:00 ~ 20:59,2748,2748,23578,26524,1519101120,50102,20231221,18-21,저녁
21:00 ~ 23:59,61,61,585,247,5659890,832,20231221,21-24,저녁
합계,7283,7283,73632,69434,3726257190,143066,20231221,,
00:00 ~ 2:59,0,0,0,0,0,0,20231222,0-3,심야
3:00 ~ 5:59,1,1,0,20,0,20,20231222,3-6,심야
6:00 ~ 8:59,0,0,0,0,0,0,20231222,6-9,심야
9:00 ~ 11:59,829,829,3469,5187,123560070,8656,20231222,9-12,주간
12:00 ~ 14:59,1868,1868,8968,23077,778212010,32045,20231222,12-15,주간
15:00 ~ 17:59,1932,1932,10696,16249,968679330,26945,20231222,15-18,주간
18:00 ~ 20:59,2660,2660,19655,33481,1479293080,53136,20231222,18-21,저녁
21:00 ~ 23:59,66,66,475,1513,67672600,1988,20231222,21-24,저녁
합계,7356,7356,43263,79527,3417417090,122790,20231222,,
00:00 ~ 2:59,0,0,0,0,0,0,20231223,0-3,심야
3:00 ~ 5:59,1,1,0,16,0,16,20231223,3-6,심야
6:00 ~ 8:59,0,0,0,0,0,0,20231223,6-9,심야
9:00 ~ 11:59,818,818,3229,4768,117455150,7997,20231223,9-12,주간
12:00 ~ 14:59,1825,1825,15369,8983,771236748,24352,20231223,12-15,주간
15:00 ~ 17:59,1866,1866,9887,16395,931816380,26282,20231223,15-18,주간
18:00 ~ 20:59,2354,2354,21110,10042,1154324070,31152,20231223,18-21,저녁
21:00 ~ 23:59,61,61,182,503,28021500,685,20231223,21-24,저녁
합계,6925,6925,49777,40707,3002853848,90484,20231223,,
00:00 ~ 2:59,0,0,0,0,0,0,20231224,0-3,심야
3:00 ~ 5:59,1,1,0,8,0,8,20231224,3-6,심야
6:00 ~ 8:59,0,0,0,0,0,0,20231224,6-9,심야
9:00 ~ 11:59,704,704,2538,3535,91609890,6073,20231224,9-12,주간
12:00 ~ 14:59,1595,1595,11989,7731,620180362,19720,20231224,12-15,주간
15:00 ~ 17:59,1575,1575,10203,11333,667755680,21536,20231224,15-18,주간
18:00 ~ 20:59,2130,2130,12184,11026,927534780,23210,20231224,18-21,저녁
21:00 ~ 23:59,51,51,266,520,25418850,786,20231224,21-24,저녁
합계,6056,6056,37180,34153,2332499562,71333,20231224,,
00:00 ~ 2:59,0,0,0,0,0,0,20231225,0-3,심야
3:00 ~ 5:59,1,1,0,16,0,16,20231225,3-6,심야
6:00 ~ 8:59,0,0,0,0,0,0,20231225,6-9,심야
9:00 ~ 11:59,649,649,1919,2509,69473740,4428,20231225,9-12,주간
12:00 ~ 14:59,1422,1422,10831,5169,491234860,16000,20231225,12-15,주간
15:00 ~ 17:59,1415,1415,8377,8578,596306280,16955,20231225,15-18,주간
18:00 ~ 20:59,2053,2053,12486,9582,781259090,22068,20231225,18-21,저녁
21:00 ~ 23:59,39,39,104,343,17013400,447,20231225,21-24,저녁
합계,5579,5579,33717,26197,1955287370,59914,20231225,,
00:00 ~ 2:59,0,0,0,0,0,0,20231226,0-3,심야
3:00 ~ 5:59,1,1,0,8,0,8,20231226,3-6,심야
6:00 ~ 8:59,0,0,0,0,0,0,20231226,6-9,심야
9:00 ~ 11:59,696,696,2153,3292,89568480,5445,20231226,9-12,주간
12:00 ~ 14:59,1482,1482,7067,9328,476762252,16395,20231226,12-15,주간
15:00 ~ 17:59,1430,1430,8623,13589,1131248770,22212,20231226,15-18,주간
18:00 ~ 20:59,2238,2238,17495,22924,1470824182,40419,20231226,18-21,저녁
21:00 ~ 23:59,33,33,178,148,9560950,326,20231226,21-24,저녁
합계,5880,5880,35516,49289,3177964634,84805,20231226,,
00:00 ~ 2:59,0,0,0,0,0,0,20231227,0-3,심야
3:00 ~ 5:59,1,1,0,24,0,24,20231227,3-6,심야
6:00 ~ 8:59,0,0,0,0,0,0,20231227,6-9,심야
9:00 ~ 11:59,720,720,2990,4656,101069600,7646,20231227,9-12,주간
12:00 ~ 14:59,1553,1553,8087,7855,488402528,15942,20231227,12-15,주간
15:00 ~ 17:59,1454,1454,9873,13362,1007918670,23235,20231227,15-18,주간
18:00 ~ 20:59,2248,2248,22435,23464,2013330804,45899,20231227,18-21,저녁
21:00 ~ 23:59,28,28,151,144,7925400,295,20231227,21-24,저녁
합계,6004,6004,43536,49505,3618647002,93041,20231227,,
00:00 ~ 2:59,0,0,0,0,0,0,20231228,0-3,심야
3:00 ~ 5:59,2,2,4,0,0,4,20231228,3-6,심야
6:00 ~ 8:59,0,0,0,0,0,0,20231228,6-9,심야
9:00 ~ 11:59,741,741,3331,5831,129614550,9162,20231228,9-12,주간
12:00 ~ 14:59,1535,1535,7217,12869,979364042,20086,20231228,12-15,주간
15:00 ~ 17:59,1526,1526,9211,15885,1253669944,25096,20231228,15-18,주간
18:00 ~ 20:59,2212,2212,18964,25729,1899715820,44693,20231228,18-21,저녁
21:00 ~ 23:59,34,34,231,134,4601600,365,20231228,21-24,저녁
합계,6050,6050,38958,60448,4266965956,99406,20231228,,
00:00 ~ 2:59,0,0,0,0,0,0,20231229,0-3,심야
3:00 ~ 5:59,0,0,0,0,0,0,20231229,3-6,심야
6:00 ~ 8:59,0,0,0,0,0,0,20231229,6-9,심야
9:00 ~ 11:59,740,740,2516,4580,93878630,7096,20231229,9-12,주간
12:00 ~ 14:59,1587,1587,9109,16544,1155218890,25653,20231229,12-15,주간
15:00 ~ 17:59,1561,1561,9918,15790,779414730,25708,20231229,15-18,주간
18:00 ~ 20:59,2148,2148,23539,32460,2618784950,55999,20231229,18-21,저녁
21:00 ~ 23:59,28,28,231,318,15121200,549,20231229,21-24,저녁
합계,6064,6064,45313,69692,4662418400,115005,20231229,,
00:00 ~ 2:59,0,0,0,0,0,0,20231230,0-3,심야
3:00 ~ 5:59,0,0,0,0,0,0,20231230,3-6,심야
6:00 ~ 8:59,0,0,0,0,0,0,20231230,6-9,심야
9:00 ~ 11:59,632,632,1825,3495,75674320,5320,20231230,9-12,주간
12:00 ~ 14:59,1516,1516,9226,10212,664566492,19438,20231230,12-15,주간
15:00 ~ 17:59,1444,1444,8403,12139,622161760,20542,20231230,15-18,주간
18:00 ~ 20:59,1875,1875,15359,11922,1154780120,27281,20231230,18-21,저녁
21:00 ~ 23:59,23,23,468,480,19153150,948,20231230,21-24,저녁
합계,5490,5490,35281,38248,2536335842,73529,20231230,,
00:00 ~ 2:59,0,0,0,0,0,0,20231231,0-3,심야
3:00 ~ 5:59,0,0,0,0,0,0,20231231,3-6,심야
6:00 ~ 8:59,0,0,0,0,0,0,20231231,6-9,심야
9:00 ~ 11:59,570,570,1587,2572,65082790,4159,20231231,9-12,주간
12:00 ~ 14:59,1342,1342,9103,8903,531257810,18006,20231231,12-15,주간
15:00 ~ 17:59,1286,1286,6843,9909,512549850,16752,20231231,15-18,주간
18:00 ~ 20:59,1756,1756,10586,9776,830929230,20362,20231231,18-21,저녁
21:00 ~ 23:59,24,24,368,1218,63507950,1586,20231231,21-24,저녁
합계,4978,4978,28487,32378,2003327630,60865,20231231,,
00:00 ~ 2:59,0,0,0,0,0,0,20240101,0-3,심야
3:00 ~ 5:59,0,0,0,0,0,0,20240101,3-6,심야
6:00 ~ 8:59,0,0,0,0,0,0,20240101,6-9,심야
9:00 ~ 11:59,623,623,861,2746,68623894,3607,20240101,9-12,주간
12:00 ~ 14:59,1341,1341,5706,7103,482553336,12809,20240101,12-15,주간
15:00 ~ 17:59,1287,1287,4025,7608,429423040,11633,20240101,15-18,주간
18:00 ~ 20:59,1785,1785,10099,8678,770728750,18777,20240101,18-21,저녁
21:00 ~ 23:59,14,14,5,47,1174550,52,20240101,21-24,저녁
합계,5050,5050,20696,26182,1752503570,46878,20240101,,
00:00 ~ 2:59,0,0,0,0,0,0,20240102,0-3,심야
3:00 ~ 5:59,0,0,0,0,0,0,20240102,3-6,심야
6:00 ~ 8:59,0,0,0,0,0,0,20240102,6-9,심야
9:00 ~ 11:59,724,724,1349,3898,92769570,5247,20240102,9-12,주간
12:00 ~ 14:59,1438,1438,5805,10637,531166480,16442,20240102,12-15,주간
15:00 ~ 17:59,1401,1401,6970,11627,466533170,18597,20240102,15-18,주간
18:00 ~ 20:59,2034,2034,15814,20318,1141469790,36132,20240102,18-21,저녁
21:00 ~ 23:59,12,12,33,72,-1493900,105,20240102,21-24,저녁
합계,5609,5609,29971,46552,2230445110,76523,20240102,,
00:00 ~ 2:59,0,0,0,0,0,0,20240103,0-3,심야
3:00 ~ 5:59,0,0,0,0,0,0,20240103,3-6,심야
6:00 ~ 8:59,0,0,0,0,0,0,20240103,6-9,심야
9:00 ~ 11:59,792,792,2434,4297,106315810,6731,20240103,9-12,주간
12:00 ~ 14:59,1515,1515,8021,10376,539172390,18397,20240103,12-15,주간
15:00 ~ 17:59,1458,1458,8135,11100,486769900,19235,20240103,15-18,주간
18:00 ~ 20:59,2069,2069,21022,26704,1982189800,47726,20240103,18-21,저녁
21:00 ~ 23:59,15,15,59,5,1468850,64,20240103,21-24,저녁
합계,5849,5849,39671,52482,3115916750,92153,20240103,,
00:00 ~ 2:59,0,0,0,0,0,0,20240104,0-3,심야
3:00 ~ 5:59,0,0,0,0,0,0,20240104,3-6,심야
6:00 ~ 8:59,0,0,0,0,0,0,20240104,6-9,심야
9:00 ~ 11:59,699,699,1935,4488,85220670,6423,20240104,9-12,주간
12:00 ~ 14:59,1521,1521,9589,10594,748077080,20183,20240104,12-15,주간
15:00 ~ 17:59,1412,1412,7449,11177,718950650,18626,20240104,15-18,주간
18:00 ~ 20:59,2065,2065,21252,19901,1916799930,41153,20240104,18-21,저녁
21:00 ~ 23:59,17,17,23,67,1462300,90,20240104,21-24,저녁
합계,5714,5714,40248,46227,3470510630,86475,20240104,,
00:00 ~ 2:59,0,0,0,0,0,0,20240105,0-3,심야
3:00 ~ 5:59,0,0,0,0,0,0,20240105,3-6,심야
6:00 ~ 8:59,0,0,0,0,0,0,20240105,6-9,심야
9:00 ~ 11:59,704,704,2646,3642,83762460,6288,20240105,9-12,주간
12:00 ~ 14:59,1500,1500,7292,13904,706300140,21196,20240105,12-15,주간
15:00 ~ 17:59,1479,1479,8901,18411,705320760,27312,20240105,15-18,주간
18:00 ~ 20:59,2116,2116,18983,29537,1898318880,48520,20240105,18-21,저녁
21:00 ~ 23:59,19,19,63,346,11429500,409,20240105,21-24,저녁
합계,5818,5818,37885,65840,3405131740,103725,20240105,,
00:00 ~ 2:59,0,0,0,0,0,0,20240106,0-3,심야
3:00 ~ 5:59,0,0,0,0,0,0,20240106,3-6,심야
6:00 ~ 8:59,0,0,0,0,0,0,20240106,6-9,심야
9:00 ~ 11:59,649,649,1771,3571,86888950,5342,20240106,9-12,주간
12:00 ~ 14:59,1470,1470,7905,10877,617658820,18782,20240106,12-15,주간
15:00 ~ 17:59,1451,1451,7057,11337,509809370,18394,20240106,15-18,주간
18:00 ~ 20:59,1913,1913,14235,12380,1042357220,26615,20240106,18-21,저녁
21:00 ~ 23:59,15,15,36,102,2863500,138,20240106,21-24,저녁
합계,5498,5498,31004,38267,2259577860,69271,20240106,,
00:00 ~ 2:59,0,0,0,0,0,0,20240107,0-3,심야
3:00 ~ 5:59,0,0,0,0,0,0,20240107,3-6,심야
6:00 ~ 8:59,0,0,0,0,0,0,20240107,6-9,심야
9:00 ~ 11:59,649,649,1538,2751,72257430,4289,20240107,9-12,주간
12:00 ~ 14:59,1418,1418,7386,8209,514626840,15595,20240107,12-15,주간
15:00 ~ 17:59,1321,1321,6258,8259,442006240,14517,20240107,15-18,주간
18:00 ~ 20:59,1894,1894,10116,10041,824336790,20157,20240107,18-21,저녁
21:00 ~ 23:59,19,19,42,97,2918000,139,20240107,21-24,저녁
합계,5301,5301,25340,29357,1856145300,54697,20240107,,
00:00 ~ 2:59,0,0,0,0,0,0,20240108,0-3,심야
3:00 ~ 5:59,0,0,0,0,0,0,20240108,3-6,심야
6:00 ~ 8:59,0,0,0,0,0,0,20240108,6-9,심야
9:00 ~ 11:59,668,668,1044,3140,78682230,4184,20240108,9-12,주간
12:00 ~ 14:59,1374,1374,5203,8055,448226990,13258,20240108,12-15,주간
15:00 ~ 17:59,1346,1346,4849,11504,418485710,16353,20240108,15-18,주간
18:00 ~ 20:59,2001,2001,13900,23859,935929770,37759,20240108,18-21,저녁
21:00 ~ 23:59,18,18,37,74,2498600,111,20240108,21-24,저녁
합계,5407,5407,25033,46632,1883823300,71665,20240108,,
00:00 ~ 2:59,1,1,0,3,156000,3,20240109,0-3,심야
3:00 ~ 5:59,0,0,0,0,0,0,20240109,3-6,심야
6:00 ~ 8:59,0,0,0,0,0,0,20240109,6-9,심야
9:00 ~ 11:59,721,721,2491,6391,121593900,8882,20240109,9-12,주간
12:00 ~ 14:59,1414,1414,7806,15375,553338160,23181,20240109,12-15,주간
15:00 ~ 17:59,1429,1429,9937,27084,2052418680,37021,20240109,15-18,주간
18:00 ~ 20:59,2157,2157,21033,36211,2174495070,57244,20240109,18-21,저녁
21:00 ~ 23:59,23,23,30,69,2191650,99,20240109,21-24,저녁
합계,5745,5745,41297,85133,4904193460,126430,20240109,,
00:00 ~ 2:59,1,1,0,5,160000,5,20240110,0-3,심야
3:00 ~ 5:59,0,0,0,0,0,0,20240110,3-6,심야
6:00 ~ 8:59,0,0,0,0,0,0,20240110,6-9,심야
9:00 ~ 11:59,718,718,2407,3782,92097930,6189,20240110,9-12,주간
12:00 ~ 14:59,1497,1497,7446,9770,531248610,17216,20240110,12-15,주간
15:00 ~ 17:59,1532,1532,8219,18166,1294304540,26385,20240110,15-18,주간
18:00 ~ 20:59,2175,2175,18098,22259,1618550590,40357,20240110,18-21,저녁
21:00 ~ 23:59,27,27,32,129,3525000,161,20240110,21-24,저녁
합계,5950,5950,36202,54111,3539886670,90313,20240110,,
00:00 ~ 2:59,1,1,9,4,128000,13,20240111,0-3,심야
3:00 ~ 5:59,0,0,0,0,0,0,20240111,3-6,심야
6:00 ~ 8:59,0,0,0,0,0,0,20240111,6-9,심야
9:00 ~ 11:59,774,774,4065,4444,105706380,8509,20240111,9-12,주간
12:00 ~ 14:59,1550,1550,10143,13999,914868222,24142,20240111,12-15,주간
15:00 ~ 17:59,1546,1546,8925,17568,992627842,26493,20240111,15-18,주간
18:00 ~ 20:59,2264,2264,20683,28700,2089581260,49383,20240111,18-21,저녁
21:00 ~ 23:59,25,25,33,165,4997400,198,20240111,21-24,저녁
합계,6160,6160,43858,64880,4107909104,108738,20240111,,
00:00 ~ 2:59,1,1,0,4,208000,4,20240112,0-3,심야
3:00 ~ 5:59,0,0,0,0,0,0,20240112,3-6,심야
6:00 ~ 8:59,0,0,0,0,0,0,20240112,6-9,심야
9:00 ~ 11:59,783,783,4455,6045,119228220,10500,20240112,9-12,주간
12:00 ~ 14:59,1557,1557,9290,13280,706424740,22570,20240112,12-15,주간
15:00 ~ 17:59,1582,1582,8537,16268,766953000,24805,20240112,15-18,주간
18:00 ~ 20:59,2228,2228,18859,27936,1793715810,46795,20240112,18-21,저녁
21:00 ~ 23:59,19,19,33,112,3460700,145,20240112,21-24,저녁
합계,6170,6170,41174,63645,3389990470,104819,20240112,,
00:00 ~ 2:59,0,0,0,0,0,0,20240113,0-3,심야
3:00 ~ 5:59,0,0,0,0,0,0,20240113,3-6,심야
6:00 ~ 8:59,0,0,0,0,0,0,20240113,6-9,심야
9:00 ~ 11:59,676,676,2175,3901,97994840,6076,20240113,9-12,주간
12:00 ~ 14:59,1492,1492,10613,7904,561522290,18517,20240113,12-15,주간
15:00 ~ 17:59,1451,1451,9146,11901,528259580,21047,20240113,15-18,주간
18:00 ~ 20:59,1964,1964,15031,10802,1006476552,25833,20240113,18-21,저녁
21:00 ~ 23:59,19,19,26,123,4181000,149,20240113,21-24,저녁
합계,5602,5602,36991,34631,2198434262,71622,20240113,,
00:00 ~ 2:59,0,0,0,0,0,0,20240114,0-3,심야
3:00 ~ 5:59,0,0,0,0,0,0,20240114,3-6,심야
6:00 ~ 8:59,0,0,0,0,0,0,20240114,6-9,심야
9:00 ~ 11:59,690,690,1843,3276,86850000,5119,20240114,9-12,주간
12:00 ~ 14:59,1464,1464,8756,12716,478895140,21472,20240114,12-15,주간
15:00 ~ 17:59,1389,1389,7046,9593,484210200,16639,20240114,15-18,주간
18:00 ~ 20:59,1940,1940,10916,21535,872628084,32451,20240114,18-21,저녁
21:00 ~ 23:59,22,22,19,91,3303700,110,20240114,21-24,저녁
합계,5505,5505,28580,47211,1925887124,75791,20240114,,
00:00 ~ 2:59,0,0,0,0,0,0,20240115,0-3,심야
3:00 ~ 5:59,0,0,0,0,0,0,20240115,3-6,심야
6:00 ~ 8:59,0,0,0,0,0,0,20240115,6-9,심야
9:00 ~ 11:59,730,730,1634,4927,95979830,6561,20240115,9-12,주간
12:00 ~ 14:59,1376,1376,5908,12253,617561790,18161,20240115,12-15,주간
15:00 ~ 17:59,1442,1442,6728,10529,461016220,17257,20240115,15-18,주간
18:00 ~ 20:59,2025,2025,17109,21478,1179796260,38587,20240115,18-21,저녁
21:00 ~ 23:59,20,20,20,67,2401000,87,20240115,21-24,저녁
합계,5593,5593,31399,49254,2356755100,80653,20240115,,
00:00 ~ 2:59,1,1,0,4,208000,4,20240116,0-3,심야
3:00 ~ 5:59,0,0,0,0,0,0,20240116,3-6,심야
6:00 ~ 8:59,0,0,0,0,0,0,20240116,6-9,심야
9:00 ~ 11:59,724,724,2761,7012,179068870,9773,20240116,9-12,주간
12:00 ~ 14:59,1408,1408,6541,11233,610157760,17774,20240116,12-15,주간
15:00 ~ 17:59,1447,1447,7255,12215,569547840,19470,20240116,15-18,주간
18:00 ~ 20:59,2087,2087,18556,23467,1850955362,42023,20240116,18-21,저녁
21:00 ~ 23:59,21,21,32,40,1371350,72,20240116,21-24,저녁
합계,5688,5688,35145,53971,3211309182,89116,20240116,,
00:00 ~ 2:59,0,0,0,0,0,0,20240117,0-3,심야
3:00 ~ 5:59,0,0,0,0,0,0,20240117,3-6,심야
6:00 ~ 8:59,0,0,0,0,0,0,20240117,6-9,심야
9:00 ~ 11:59,729,729,2236,4629,96506360,6865,20240117,9-12,주간
12:00 ~ 14:59,1447,1447,8268,9652,666817522,17920,20240117,12-15,주간
15:00 ~ 17:59,1494,1494,7112,11850,520866742,18962,20240117,15-18,주간
18:00 ~ 20:59,2129,2129,20863,21072,1330007562,41935,20240117,18-21,저녁
21:00 ~ 23:59,22,22,18,85,2657850,103,20240117,21-24,저녁
합계,5821,5821,38497,47288,2616856036,85785,20240117,,
00:00 ~ 2:59,0,0,0,0,0,0,20240118,0-3,심야
3:00 ~ 5:59,1,1,0,1,15000,1,20240118,3-6,심야
6:00 ~ 8:59,0,0,0,0,0,0,20240118,6-9,심야
9:00 ~ 11:59,764,764,2660,7481,137806540,10141,20240118,9-12,주간
12:00 ~ 14:59,1536,1536,9095,18278,1448920300,27373,20240118,12-15,주간
15:00 ~ 17:59,1534,1534,7350,16615,693093940,23965,20240118,15-18,주간
18:00 ~ 20:59,2224,2224,22577,34424,2712146552,57001,20240118,18-21,저녁
21:00 ~ 23:59,22,22,24,79,2439400,103,20240118,21-24,저녁
합계,6081,6081,41706,76878,4994421732,118584,20240118,,
00:00 ~ 2:59,1,1,0,24,948000,24,20240119,0-3,심야
3:00 ~ 5:59,2,2,2,10,150000,12,20240119,3-6,심야
6:00 ~ 8:59,0,0,0,0,0,0,20240119,6-9,심야
9:00 ~ 11:59,691,691,2297,4460,118856830,6757,20240119,9-12,주간
12:00 ~ 14:59,1529,1529,11231,23589,1770542275,34820,20240119,12-15,주간
15:00 ~ 17:59,1565,1565,7851,14084,625647375,21935,20240119,15-18,주간
18:00 ~ 20:59,2170,2170,24218,39586,3311127182,63804,20240119,18-21,저녁
21:00 ~ 23:59,16,16,20,81,2371150,101,20240119,21-24,저녁
합계,5974,5974,45619,81834,5829642812,127453,20240119,,
00:00 ~ 2:59,0,0,0,0,0,0,20240120,0-3,심야
3:00 ~ 5:59,1,1,0,2,30000,2,20240120,3-6,심야
6:00 ~ 8:59,0,0,0,0,0,0,20240120,6-9,심야
9:00 ~ 11:59,683,683,2711,3791,100306400,6502,20240120,9-12,주간
12:00 ~ 14:59,1482,1482,12456,10595,818346020,23051,20240120,12-15,주간
15:00 ~ 17:59,1468,1468,9538,10770,493577990,20308,20240120,15-18,주간
18:00 ~ 20:59,1978,1978,16843,16603,1362899322,33446,20240120,18-21,저녁
21:00 ~ 23:59,14,14,12,91,2127400,103,20240120,21-24,저녁
합계,5626,5626,41560,41852,2777287132,83412,20240120,,
00:00 ~ 2:59,0,0,0,0,0,0,20240121,0-3,심야
3:00 ~ 5:59,0,0,0,0,0,0,20240121,3-6,심야
6:00 ~ 8:59,0,0,0,0,0,0,20240121,6-9,심야
9:00 ~ 11:59,638,638,1940,2929,92972200,4869,20240121,9-12,주간
12:00 ~ 14:59,1405,1405,10330,10125,730313720,20455,20240121,12-15,주간
15:00 ~ 17:59,1373,1373,7413,8307,425402900,15720,20240121,15-18,주간
18:00 ~ 20:59,1960,1960,14797,13049,1153648580,27846,20240121,18-21,저녁
21:00 ~ 23:59,19,19,27,17,457000,44,20240121,21-24,저녁
합계,5395,5395,34507,34427,2402794400,68934,20240121,,
00:00 ~ 2:59,1,1,0,22,984000,22,20240122,0-3,심야
3:00 ~ 5:59,1,1,2,-2,-30000,0,20240122,3-6,심야
6:00 ~ 8:59,0,0,0,0,0,0,20240122,6-9,심야
9:00 ~ 11:59,679,679,1217,3898,124412460,5115,20240122,9-12,주간
12:00 ~ 14:59,1361,1361,7419,10797,761260840,18216,20240122,12-15,주간
15:00 ~ 17:59,1362,1362,5352,10163,425449740,15515,20240122,15-18,주간
18:00 ~ 20:59,2125,2125,16912,19795,1314974692,36707,20240122,18-21,저녁
21:00 ~ 23:59,16,16,33,21,991000,54,20240122,21-24,저녁
합계,5545,5545,30935,44694,2628042732,75629,20240122,,
00:00 ~ 2:59,1,1,10,15,600000,25,20240123,0-3,심야
3:00 ~ 5:59,0,0,0,0,0,0,20240123,3-6,심야
6:00 ~ 8:59,0,0,0,0,0,0,20240123,6-9,심야
9:00 ~ 11:59,658,658,2097,3089,100960760,5186,20240123,9-12,주간
12:00 ~ 14:59,1413,1413,9376,13887,1110713200,23263,20240123,12-15,주간
15:00 ~ 17:59,1471,1471,6755,16412,644915600,23167,20240123,15-18,주간
18:00 ~ 20:59,2267,2267,21578,24441,2118473382,46019,20240123,18-21,저녁
21:00 ~ 23:59,15,15,17,65,2121100,82,20240123,21-24,저녁
합계,5825,5825,39833,57909,3977784042,97742,20240123,,
00:00 ~ 2:59,1,1,4,26,992000,30,20240124,0-3,심야
3:00 ~ 5:59,0,0,0,0,0,0,20240124,3-6,심야
6:00 ~ 8:59,0,0,0,0,0,0,20240124,6-9,심야
9:00 ~ 11:59,708,708,3404,3933,20595700,7337,20240124,9-12,주간
12:00 ~ 14:59,1479,1479,8450,11090,658153980,19540,20240124,12-15,주간
15:00 ~ 17:59,1513,1513,6573,13152,510130830,19725,20240124,15-18,주간
18:00 ~ 20:59,2295,2295,21034,26778,2110968240,47812,20240124,18-21,저녁
21:00 ~ 23:59,18,18,17,61,1547150,78,20240124,21-24,저녁
합계,6014,6014,39482,55040,3302387900,94522,20240124,,
00:00 ~ 2:59,1,1,0,11,472000,11,20240125,0-3,심야
3:00 ~ 5:59,0,0,0,0,0,0,20240125,3-6,심야
6:00 ~ 8:59,0,0,0,0,0,0,20240125,6-9,심야
9:00 ~ 11:59,703,703,2164,3992,98929530,6156,20240125,9-12,주간
12:00 ~ 14:59,1471,1471,11137,16041,897558420,27178,20240125,12-15,주간
15:00 ~ 17:59,1505,1505,8717,37934,4422416652,46651,20240125,15-18,주간
18:00 ~ 20:59,2311,2311,22696,48025,5491005731,70721,20240125,18-21,저녁
21:00 ~ 23:59,15,15,7,61,1714300,68,20240125,21-24,저녁
합계,6006,6006,44721,106064,10912096633,150785,20240125,,
00:00 ~ 2:59,1,1,0,3,156000,3,20240126,0-3,심야
3:00 ~ 5:59,0,0,0,0,0,0,20240126,3-6,심야
6:00 ~ 8:59,0,0,0,0,0,0,20240126,6-9,심야
9:00 ~ 11:59,700,700,2613,5024,128274150,7637,20240126,9-12,주간
12:00 ~ 14:59,1510,1510,7600,12924,601265511,20524,20240126,12-15,주간
15:00 ~ 17:59,1527,1527,7659,16097,759554440,23756,20240126,15-18,주간
18:00 ~ 20:59,2213,2213,17176,24876,1498083870,42052,20240126,18-21,저녁
21:00 ~ 23:59,15,15,16,44,627100,60,20240126,21-24,저녁
합계,5966,5966,35064,58968,2987961071,94032,20240126,,
00:00 ~ 2:59,0,0,0,0,0,0,20240127,0-3,심야
3:00 ~ 5:59,0,0,0,0,0,0,20240127,3-6,심야
6:00 ~ 8:59,0,0,0,0,0,0,20240127,6-9,심야
9:00 ~ 11:59,673,673,2101,3889,103557500,5990,20240127,9-12,주간
12:00 ~ 14:59,1496,1496,9277,10306,604788790,19583,20240127,12-15,주간
15:00 ~ 17:59,1469,1469,8135,14210,502622650,22345,20240127,15-18,주간
18:00 ~ 20:59,1984,1984,12453,11715,953753480,24168,20240127,18-21,저녁
21:00 ~ 23:59,13,13,8,74,1848100,82,20240127,21-24,저녁
합계,5635,5635,31974,40194,2166570520,72168,20240127,,
00:00 ~ 2:59,0,0,0,0,0,0,20240128,0-3,심야
3:00 ~ 5:59,1,1,2,-2,-30000,0,20240128,3-6,심야
6:00 ~ 8:59,0,0,0,0,0,0,20240128,6-9,심야
9:00 ~ 11:59,637,637,1526,3461,87437890,4987,20240128,9-12,주간
12:00 ~ 14:59,1376,1376,7370,9365,552701790,16735,20240128,12-15,주간
15:00 ~ 17:59,1392,1392,7423,6874,379085112,14297,20240128,15-18,주간
18:00 ~ 20:59,1906,1906,9583,10682,847339280,20265,20240128,18-21,저녁
21:00 ~ 23:59,13,13,14,71,1473600,85,20240128,21-24,저녁
합계,5325,5325,25918,30451,1868007672,56369,20240128,,
00:00 ~ 2:59,1,1,0,22,784000,22,20240129,0-3,심야
3:00 ~ 5:59,0,0,0,0,0,0,20240129,3-6,심야
6:00 ~ 8:59,0,0,0,0,0,0,20240129,6-9,심야
9:00 ~ 11:59,657,657,2720,4657,84220690,7377,20240129,9-12,주간
12:00 ~ 14:59,1326,1326,5869,8226,471652230,14095,20240129,12-15,주간
15:00 ~ 17:59,1326,1326,5910,11302,919031210,17212,20240129,15-18,주간
18:00 ~ 20:59,2020,2020,15476,24436,1925240610,39912,20240129,18-21,저녁
21:00 ~ 23:59,9,9,15,17,581100,32,20240129,21-24,저녁
합계,5339,5339,29990,48660,3401509840,78650,20240129,,
00:00 ~ 2:59,1,1,0,30,1340000,30,20240130,0-3,심야
3:00 ~ 5:59,1,1,4,-4,-60000,0,20240130,3-6,심야
6:00 ~ 8:59,0,0,0,0,0,0,20240130,6-9,심야
9:00 ~ 11:59,657,657,1746,4641,157163410,6387,20240130,9-12,주간
12:00 ~ 14:59,1418,1418,9315,15066,1155666882,24381,20240130,12-15,주간
15:00 ~ 17:59,1412,1412,5917,14281,773108280,20198,20240130,15-18,주간
18:00 ~ 20:59,2163,2163,21400,31219,2499349745,52619,20240130,18-21,저녁
21:00 ~ 23:59,15,15,11,45,1062900,56,20240130,21-24,저녁
합계,5667,5667,38393,65278,4587631217,103671,20240130,,
00:00 ~ 2:59,1,1,0,3,136000,3,20240131,0-3,심야
3:00 ~ 5:59,0,0,0,0,0,0,20240131,3-6,심야
6:00 ~ 8:59,0,0,0,0,0,0,20240131,6-9,심야
9:00 ~ 11:59,663,663,1890,3901,101910470,5791,20240131,9-12,주간
12:00 ~ 14:59,1476,1476,9840,10141,727881830,19981,20240131,12-15,주간
15:00 ~ 17:59,1479,1479,6760,11268,584610020,18028,20240131,15-18,주간
18:00 ~ 20:59,2203,2203,23047,25830,1832537460,48877,20240131,18-21,저녁
21:00 ~ 23:59,20,20,18,72,1436200,90,20240131,21-24,저녁
합계,5842,5842,41555,51215,3248511980,92770,20240131,,
00:00 ~ 2:59,1,1,0,56,2392000,56,20240201,0-3,심야
3:00 ~ 5:59,0,0,0,0,0,0,20240201,3-6,심야
6:00 ~ 8:59,0,0,0,0,0,0,20240201,6-9,심야
9:00 ~ 11:59,719,719,2258,4831,172989750,7089,20240201,9-12,주간
12:00 ~ 14:59,1515,1515,9515,13004,898779471,22519,20240201,12-15,주간
15:00 ~ 17:59,1508,1508,7934,16039,1119271042,23973,20240201,15-18,주간
18:00 ~ 20:59,2289,2289,22062,31302,2419788976,53364,20240201,18-21,저녁
21:00 ~ 23:59,16,16,12,58,1734300,70,20240201,21-24,저녁
합계,6048,6048,41781,65290,4614955539,107071,20240201,,
00:00 ~ 2:59,1,1,12,26,1032000,38,20240202,0-3,심야
3:00 ~ 5:59,0,0,0,0,0,0,20240202,3-6,심야
6:00 ~ 8:59,0,0,0,0,0,0,20240202,6-9,심야
9:00 ~ 11:59,668,668,2048,4053,110147330,6101,20240202,9-12,주간
12:00 ~ 14:59,1539,1539,10344,14551,898487330,24895,20240202,12-15,주간
15:00 ~ 17:59,1541,1541,7392,19882,1357815620,27274,20240202,15-18,주간
18:00 ~ 20:59,2154,2154,19829,30136,2768825790,49965,20240202,18-21,저녁
21:00 ~ 23:59,13,13,13,41,802350,54,20240202,21-24,저녁
합계,5916,5916,39638,68689,5137110420,108327,20240202,,
00:00 ~ 2:59,0,0,0,0,0,0,20240203,0-3,심야
3:00 ~ 5:59,0,0,0,0,0,0,20240203,3-6,심야
6:00 ~ 8:59,0,0,0,0,0,0,20240203,6-9,심야
9:00 ~ 11:59,656,656,1528,4332,109342510,5860,20240203,9-12,주간
12:00 ~ 14:59,1447,1447,10075,10093,683059650,20168,20240203,12-15,주간
15:00 ~ 17:59,1479,1479,7731,11388,477968450,19119,20240203,15-18,주간
18:00 ~ 20:59,1880,1880,14730,13565,1205015600,28295,20240203,18-21,저녁
21:00 ~ 23:59,11,11,14,17,461100,31,20240203,21-24,저녁
합계,5473,5473,34078,39395,2475847310,73473,20240203,,
00:00 ~ 2:59,0,0,0,0,0,0,20240204,0-3,심야
3:00 ~ 5:59,0,0,0,0,0,0,20240204,3-6,심야
6:00 ~ 8:59,0,0,0,0,0,0,20240204,6-9,심야
9:00 ~ 11:59,597,597,1467,3325,91548350,4792,20240204,9-12,주간
12:00 ~ 14:59,1402,1402,9426,7351,592226669,16777,20240204,12-15,주간
15:00 ~ 17:59,1365,1365,5525,7332,340698150,12857,20240204,15-18,주간
18:00 ~ 20:59,1854,1854,12051,10194,891545330,22245,20240204,18-21,저녁
21:00 ~ 23:59,11,11,3,33,918100,36,20240204,21-24,저녁
합계,5229,5229,28472,28235,1916936599,56707,20240204,,
00:00 ~ 2:59,1,1,0,10,460000,10,20240205,0-3,심야
3:00 ~ 5:59,0,0,0,0,0,0,20240205,3-6,심야
6:00 ~ 8:59,0,0,0,0,0,0,20240205,6-9,심야
9:00 ~ 11:59,617,617,1155,2624,82280770,3779,20240205,9-12,주간
12:00 ~ 14:59,1310,1310,7829,12874,1053998020,20703,20240205,12-15,주간
15:00 ~ 17:59,1355,1355,4863,7612,332777290,12475,20240205,15-18,주간
18:00 ~ 20:59,1948,1948,16471,21538,1600268990,38009,20240205,18-21,저녁
21:00 ~ 23:59,9,9,9,17,314000,26,20240205,21-24,저녁
합계,5240,5240,30327,44675,3070099070,75002,20240205,,
00:00 ~ 2:59,1,1,0,4,208000,4,20240206,0-3,심야
3:00 ~ 5:59,1,1,1,-1,-15000,0,20240206,3-6,심야
6:00 ~ 8:59,0,0,0,0,0,0,20240206,6-9,심야
9:00 ~ 11:59,656,656,2425,7551,199477450,9976,20240206,9-12,주간
12:00 ~ 14:59,1342,1342,10940,29244,3011634890,40184,20240206,12-15,주간
15:00 ~ 17:59,1406,1406,5899,15201,662218930,21100,20240206,15-18,주간
18:00 ~ 20:59,2095,2095,23290,41203,3158918662,64493,20240206,18-21,저녁
21:00 ~ 23:59,13,13,17,40,596100,57,20240206,21-24,저녁
합계,5514,5514,42572,93242,7033039032,135814,20240206,,
00:00 ~ 2:59,1,1,0,8,416000,8,20240207,0-3,심야
3:00 ~ 5:59,0,0,0,0,0,0,20240207,3-6,심야
6:00 ~ 8:59,0,0,0,0,0,0,20240207,6-9,심야
9:00 ~ 11:59,665,665,1577,4586,100235958,6163,20240207,9-12,주간
12:00 ~ 14:59,1377,1377,11555,14926,1440144242,26481,20240207,12-15,주간
15:00 ~ 17:59,1400,1400,5995,13558,582357572,19553,20240207,15-18,주간
18:00 ~ 20:59,2039,2039,19999,28910,2183932570,48909,20240207,18-21,저녁
21:00 ~ 23:59,13,13,12,42,916500,54,20240207,21-24,저녁
합계,5495,5495,39138,62030,4308002842,101168,20240207,,
00:00 ~ 2:59,0,0,0,0,0,0,20240208,0-3,심야
3:00 ~ 5:59,0,0,0,0,0,0,20240208,3-6,심야
6:00 ~ 8:59,0,0,0,0,0,0,20240208,6-9,심야
9:00 ~ 11:59,616,616,1787,4638,108582460,6425,20240208,9-12,주간
12:00 ~ 14:59,1411,1411,7952,15156,744709564,23108,20240208,12-15,주간
15:00 ~ 17:59,1455,1455,5431,13598,459854040,19029,20240208,15-18,주간
18:00 ~ 20:59,2103,2103,16787,28620,2086503780,45407,20240208,18-21,저녁
21:00 ~ 23:59,9,9,8,53,878400,61,20240208,21-24,저녁
합계,5594,5594,31965,62065,3400528244,94030,20240208,,
00:00 ~ 2:59,0,0,0,0,0,0,20240209,0-3,심야
3:00 ~ 5:59,0,0,0,0,0,0,20240209,3-6,심야
6:00 ~ 8:59,0,0,0,0,0,0,20240209,6-9,심야
9:00 ~ 11:59,510,510,1263,2527,80325720,3790,20240209,9-12,주간
12:00 ~ 14:59,1282,1282,7619,10826,703398470,18445,20240209,12-15,주간
15:00 ~ 17:59,1336,1336,4818,7451,355873840,12269,20240209,15-18,주간
18:00 ~ 20:59,1853,1853,9941,14302,1203835720,24243,20240209,18-21,저녁
21:00 ~ 23:59,10,10,4,42,1144000,46,20240209,21-24,저녁
합계,4991,4991,23645,35148,2344577750,58793,20240209,,
00:00 ~ 2:59,0,0,0,0,0,0,20240210,0-3,심야
3:00 ~ 5:59,0,0,0,0,0,0,20240210,3-6,심야
6:00 ~ 8:59,0,0,0,0,0,0,20240210,6-9,심야
9:00 ~ 11:59,467,467,701,2024,65851870,2725,20240210,9-12,주간
12:00 ~ 14:59,1167,1167,6055,7998,643569202,14053,20240210,12-15,주간
15:00 ~ 17:59,1232,1232,3675,7090,326369550,10765,20240210,15-18,주간
18:00 ~ 20:59,1765,1765,7905,11503,1023147880,19408,20240210,18-21,저녁
21:00 ~ 23:59,9,9,10,9,258500,19,20240210,21-24,저녁
합계,4640,4640,18346,28624,2059197002,46970,20240210,,
00:00 ~ 2:59,0,0,0,0,0,0,20240211,0-3,심야
3:00 ~ 5:59,0,0,0,0,0,0,20240211,3-6,심야
6:00 ~ 8:59,0,0,0,0,0,0,20240211,6-9,심야
9:00 ~ 11:59,523,523,880,2769,78280780,3649,20240211,9-12,주간
12:00 ~ 14:59,1255,1255,6771,9285,535826401,16056,20240211,12-15,주간
15:00 ~ 17:59,1239,1239,4530,8243,304700570,12773,20240211,15-18,주간
18:00 ~ 20:59,1783,1783,8059,10108,753681031,18167,20240211,18-21,저녁
21:00 ~ 23:59,7,7,7,12,223500,19,20240211,21-24,저녁
합계,4807,4807,20247,30417,1672712282,50664,20240211,,
00:00 ~ 2:59,0,0,0,0,0,0,20240212,0-3,심야
3:00 ~ 5:59,0,0,0,0,0,0,20240212,3-6,심야
6:00 ~ 8:59,0,0,0,0,0,0,20240212,6-9,심야
9:00 ~ 11:59,577,577,1136,2753,84583140,3889,20240212,9-12,주간
12:00 ~ 14:59,1236,1236,6955,7545,549175030,14500,20240212,12-15,주간
15:00 ~ 17:59,1302,1302,3933,6589,290369720,10522,20240212,15-18,주간
18:00 ~ 20:59,1819,1819,7894,9908,703635620,17802,20240212,18-21,저녁
21:00 ~ 23:59,11,11,13,22,266600,35,20240212,21-24,저녁
합계,4945,4945,19931,26817,1628030110,46748,20240212,,
00:00 ~ 2:59,0,0,0,0,0,0,20240213,0-3,심야
3:00 ~ 5:59,0,0,0,0,0,0,20240213,3-6,심야
6:00 ~ 8:59,0,0,0,0,0,0,20240213,6-9,심야
9:00 ~ 11:59,654,654,2514,6373,135976250,8887,20240213,9-12,주간
12:00 ~ 14:59,1266,1266,6647,12814,513218380,19461,20240213,12-15,주간
15:00 ~ 17:59,1457,1457,5558,12482,542222570,18040,20240213,15-18,주간
18:00 ~ 20:59,2106,2106,16449,21064,854398470,37513,20240213,18-21,저녁
21:00 ~ 23:59,13,13,24,224,11410100,248,20240213,21-24,저녁
합계,5496,5496,31192,52957,2057225770,84149,20240213,,
00:00 ~ 2:59,0,0,0,0,0,0,20240214,0-3,심야
3:00 ~ 5:59,0,0,0,0,0,0,20240214,3-6,심야
6:00 ~ 8:59,0,0,0,0,0,0,20240214,6-9,심야
9:00 ~ 11:59,666,666,3331,6297,142768570,9628,20240214,9-12,주간
12:00 ~ 14:59,1319,1319,8393,13767,1066699420,22160,20240214,12-15,주간
15:00 ~ 17:59,1515,1515,9169,25060,2406281910,34229,20240214,15-18,주간
18:00 ~ 20:59,2221,2221,28756,53969,6112497230,82725,20240214,18-21,저녁
21:00 ~ 23:59,17,17,37,46,886660,83,20240214,21-24,저녁
합계,5738,5738,49686,99139,9729133790,148825,20240214,,
00:00 ~ 2:59,0,0,0,0,0,0,20240215,0-3,심야
3:00 ~ 5:59,0,0,0,0,0,0,20240215,3-6,심야
6:00 ~ 8:59,0,0,0,0,0,0,20240215,6-9,심야
9:00 ~ 11:59,709,709,2768,5673,135150580,8441,20240215,9-12,주간
12:00 ~ 14:59,1394,1394,10531,20799,1608432870,31330,20240215,12-15,주간
15:00 ~ 17:59,1558,1558,9421,14942,796863090,24363,20240215,15-18,주간
18:00 ~ 20:59,2331,2331,32756,50366,4615546350,83122,20240215,18-21,저녁
21:00 ~ 23:59,11,11,13,42,832300,55,20240215,21-24,저녁
합계,6003,6003,55489,91822,7156825190,147311,20240215,,
00:00 ~ 2:59,0,0,0,0,0,0,20240216,0-3,심야
3:00 ~ 5:59,0,0,0,0,0,0,20240216,3-6,심야
6:00 ~ 8:59,0,0,0,0,0,0,20240216,6-9,심야
9:00 ~ 11:59,696,696,2503,4067,105599000,6570,20240216,9-12,주간
12:00 ~ 14:59,1471,1471,9343,16528,1013810000,25871,20240216,12-15,주간
15:00 ~ 17:59,1551,1551,9025,16394,805805650,25419,20240216,15-18,주간
18:00 ~ 20:59,2283,2283,24551,38983,2415449520,63534,20240216,18-21,저녁
21:00 ~ 23:59,12,12,10,39,747400,49,20240216,21-24,저녁
합계,6013,6013,45432,76011,4341411570,121443,20240216,,
00:00 ~ 2:59,0,0,0,0,0,0,20240217,0-3,심야
3:00 ~ 5:59,0,0,0,0,0,0,20240217,3-6,심야
6:00 ~ 8:59,0,0,0,0,0,0,20240217,6-9,심야
9:00 ~ 11:59,673,673,1870,3861,101092350,5731,20240217,9-12,주간
12:00 ~ 14:59,1389,1389,7961,10704,738617550,18665,20240217,12-15,주간
15:00 ~ 17:59,1476,1476,6828,11356,439431850,18184,20240217,15-18,주간
18:00 ~ 20:59,1996,1996,17412,13210,1340621842,30622,20240217,18-21,저녁
21:00 ~ 23:59,12,12,13,47,671000,60,20240217,21-24,저녁
합계,5546,5546,34084,39178,2620434592,73262,20240217,,
00:00 ~ 2:59,0,0,0,0,0,0,20240218,0-3,심야
3:00 ~ 5:59,0,0,0,0,0,0,20240218,3-6,심야
6:00 ~ 8:59,0,0,0,0,0,0,20240218,6-9,심야
9:00 ~ 11:59,624,624,1576,2991,85215700,4567,20240218,9-12,주간
12:00 ~ 14:59,1269,1269,7054,8491,602396780,15545,20240218,12-15,주간
15:00 ~ 17:59,1395,1395,4827,8984,380222300,13811,20240218,15-18,주간
18:00 ~ 20:59,1913,1913,11879,10072,1006043240,21951,20240218,18-21,저녁
21:00 ~ 23:59,12,12,18,37,347100,55,20240218,21-24,저녁
합계,5213,5213,25354,30575,2074225120,55929,20240218,,
00:00 ~ 2:59,0,0,0,0,0,0,20240219,0-3,심야
3:00 ~ 5:59,0,0,0,0,0,0,20240219,3-6,심야
6:00 ~ 8:59,0,0,0,0,0,0,20240219,6-9,심야
9:00 ~ 11:59,643,643,1072,3439,100301320,4511,20240219,9-12,주간
12:00 ~ 14:59,1241,1241,5713,11263,818752400,16976,20240219,12-15,주간
15:00 ~ 17:59,1429,1429,5066,10971,439431140,16037,20240219,15-18,주간
18:00 ~ 20:59,2144,2144,15335,18767,1285459300,34102,20240219,18-21,저녁
21:00 ~ 23:59,11,11,28,168,11060100,196,20240219,21-24,저녁
합계,5468,5468,27214,44608,2655004260,71822,20240219,,
00:00 ~ 2:59,0,0,0,0,0,0,20240220,0-3,심야
3:00 ~ 5:59,0,0,0,0,0,0,20240220,3-6,심야
6:00 ~ 8:59,0,0,0,0,0,0,20240220,6-9,심야
9:00 ~ 11:59,678,678,2086,4413,128220570,6499,20240220,9-12,주간
12:00 ~ 14:59,1330,1330,14822,14261,1118880850,29083,20240220,12-15,주간
15:00 ~ 17:59,1486,1486,8070,19182,1320702780,27252,20240220,15-18,주간
18:00 ~ 20:59,2271,2271,24495,40165,3208979400,64660,20240220,18-21,저녁
21:00 ~ 23:59,13,13,18,187,10175400,205,20240220,21-24,저녁
합계,5778,5778,49491,78208,5786959000,127699,20240220,,
00:00 ~ 2:59,0,0,0,0,0,0,20240221,0-3,심야
3:00 ~ 5:59,0,0,0,0,0,0,20240221,3-6,심야
6:00 ~ 8:59,0,0,0,0,0,0,20240221,6-9,심야
9:00 ~ 11:59,705,705,1835,5037,98021060,6872,20240221,9-12,주간
12:00 ~ 14:59,1359,1359,7907,10115,779495120,18022,20240221,12-15,주간
15:00 ~ 17:59,1480,1480,5935,10405,442014350,16340,20240221,15-18,주간
18:00 ~ 20:59,2297,2297,19830,23629,1714400302,43459,20240221,18-21,저녁
21:00 ~ 23:59,19,19,11,82,3312700,93,20240221,21-24,저녁
합계,5860,5860,35518,49268,3037243532,84786,20240221,,
00:00 ~ 2:59,0,0,0,0,0,0,20240222,0-3,심야
3:00 ~ 5:59,0,0,0,0,0,0,20240222,3-6,심야
6:00 ~ 8:59,0,0,0,0,0,0,20240222,6-9,심야
9:00 ~ 11:59,637,637,1804,3520,96775810,5324,20240222,9-12,주간
12:00 ~ 14:59,1334,1334,8539,18749,1564731792,27288,20240222,12-15,주간
15:00 ~ 17:59,1456,1456,6074,13848,445065840,19922,20240222,15-18,주간
18:00 ~ 20:59,2251,2251,20362,28127,1631390352,48489,20240222,18-21,저녁
21:00 ~ 23:59,18,18,24,73,2366950,97,20240222,21-24,저녁
합계,5696,5696,36803,64317,3740330744,101120,20240222,,
00:00 ~ 2:59,0,0,0,0,0,0,20240223,0-3,심야
3:00 ~ 5:59,0,0,0,0,0,0,20240223,3-6,심야
6:00 ~ 8:59,0,0,0,0,0,0,20240223,6-9,심야
9:00 ~ 11:59,674,674,2113,4938,106095360,7051,20240223,9-12,주간
12:00 ~ 14:59,1403,1403,6759,15265,804691798,22024,20240223,12-15,주간
15:00 ~ 17:59,1542,1542,7683,14807,540329440,22490,20240223,15-18,주간
18:00 ~ 20:59,2198,2198,15372,22851,1293857290,38223,20240223,18-21,저녁
21:00 ~ 23:59,15,15,28,76,2498100,104,20240223,21-24,저녁
합계,5832,5832,31955,57937,2747471988,89892,20240223,,
00:00 ~ 2:59,0,0,0,0,0,0,20240224,0-3,심야
3:00 ~ 5:59,0,0,0,0,0,0,20240224,3-6,심야
6:00 ~ 8:59,0,0,0,0,0,0,20240224,6-9,심야
9:00 ~ 11:59,629,629,1646,3493,89585230,5139,20240224,9-12,주간
12:00 ~ 14:59,1377,1377,7634,10009,609104390,17643,20240224,12-15,주간
15:00 ~ 17:59,1504,1504,6030,11373,450579690,17403,20240224,15-18,주간
18:00 ~ 20:59,2010,2010,11112,12700,926433760,23812,20240224,18-21,저녁
21:00 ~ 23:59,12,12,19,66,1728100,85,20240224,21-24,저녁
합계,5532,5532,26441,37641,2077431170,64082,20240224,,
00:00 ~ 2:59,0,0,0,0,0,0,20240225,0-3,심야
3:00 ~ 5:59,0,0,0,0,0,0,20240225,3-6,심야
6:00 ~ 8:59,0,0,0,0,0,0,20240225,6-9,심야
9:00 ~ 11:59,594,594,1750,3011,90258170,4761,20240225,9-12,주간
12:00 ~ 14:59,1292,1292,6631,8958,591065282,15589,20240225,12-15,주간
15:00 ~ 17:59,1365,1365,4632,9177,362027782,13809,20240225,15-18,주간
18:00 ~ 20:59,1949,1949,8457,8779,780580720,17236,20240225,18-21,저녁
21:00 ~ 23:59,14,14,14,69,1570600,83,20240225,21-24,저녁
합계,5214,5214,21484,29994,1825502554,51478,20240225,,
00:00 ~ 2:59,0,0,0,0,0,0,20240226,0-3,심야
3:00 ~ 5:59,0,0,0,0,0,0,20240226,3-6,심야
6:00 ~ 8:59,0,0,0,0,0,0,20240226,6-9,심야
9:00 ~ 11:59,597,597,1110,3591,86564160,4701,20240226,9-12,주간
12:00 ~ 14:59,1249,1249,7638,24986,2225200340,32624,20240226,12-15,주간
15:00 ~ 17:59,1397,1397,5125,11061,367100870,16186,20240226,15-18,주간
18:00 ~ 20:59,2152,2152,14001,21709,1417633360,35710,20240226,18-21,저녁
21:00 ~ 23:59,12,12,19,23,891350,42,20240226,21-24,저녁
합계,5407,5407,27893,61370,4097390080,89263,20240226,,
00:00 ~ 2:59,0,0,0,0,0,0,20240227,0-3,심야
3:00 ~ 5:59,0,0,0,0,0,0,20240227,3-6,심야
6:00 ~ 8:59,0,0,0,0,0,0,20240227,6-9,심야
9:00 ~ 11:59,607,607,2135,3343,96284370,5478,20240227,9-12,주간
12:00 ~ 14:59,1235,1235,6039,12443,899958940,18482,20240227,12-15,주간
15:00 ~ 17:59,1418,1418,6376,9803,570423170,16179,20240227,15-18,주간
18:00 ~ 20:59,2235,2235,15133,26350,1756351670,41483,20240227,18-21,저녁
21:00 ~ 23:59,13,13,19,54,1599200,73,20240227,21-24,저녁
합계,5508,5508,29702,51993,3324617350,81695,20240227,,
00:00 ~ 2:59,0,0,0,0,0,0,20240228,0-3,심야
3:00 ~ 5:59,0,0,0,0,0,0,20240228,3-6,심야
6:00 ~ 8:59,0,0,0,0,0,0,20240228,6-9,심야
9:00 ~ 11:59,599,599,1980,4170,106697050,6150,20240228,9-12,주간
12:00 ~ 14:59,1327,1327,7555,11590,747641440,19145,20240228,12-15,주간
15:00 ~ 17:59,1508,1508,5326,12351,432944430,17677,20240228,15-18,주간
18:00 ~ 20:59,2305,2305,19650,27654,1743815870,47304,20240228,18-21,저녁
21:00 ~ 23:59,18,18,20,72,1751400,92,20240228,21-24,저녁
합계,5757,5757,34531,55837,3032850190,90368,20240228,,
00:00 ~ 2:59,0,0,0,0,0,0,20240229,0-3,심야
3:00 ~ 5:59,0,0,0,0,0,0,20240229,3-6,심야
6:00 ~ 8:59,0,0,0,0,0,0,20240229,6-9,심야
9:00 ~ 11:59,641,641,2136,5376,146195790,7512,20240229,9-12,주간
12:00 ~ 14:59,1336,1336,8743,16002,967300140,24745,20240229,12-15,주간
15:00 ~ 17:59,1572,1572,5938,16845,411885620,22783,20240229,15-18,주간
18:00 ~ 20:59,2283,2283,18000,21093,1273728980,39093,20240229,18-21,저녁
21:00 ~ 23:59,16,16,62,27,18800,89,20240229,21-24,저녁
합계,5848,5848,34879,59343,2799129330,94222,20240229,,
00:00 ~ 2:59,0,0,0,0,0,0,20240301,0-3,심야
3:00 ~ 5:59,0,0,0,0,0,0,20240301,3-6,심야
6:00 ~ 8:59,0,0,0,0,0,0,20240301,6-9,심야
9:00 ~ 11:59,612,612,1618,4076,111695280,5694,20240301,9-12,주간
12:00 ~ 14:59,1340,1340,7745,12058,776066710,19803,20240301,12-15,주간
15:00 ~ 17:59,1521,1521,5097,11000,412227200,16097,20240301,15-18,주간
18:00 ~ 20:59,2151,2151,10769,14504,986633120,25273,20240301,18-21,저녁
21:00 ~ 23:59,13,13,8,54,2284000,62,20240301,21-24,저녁
합계,5637,5637,25237,41692,2288906310,66929,20240301,,
00:00 ~ 2:59,0,0,0,0,0,0,20240302,0-3,심야
3:00 ~ 5:59,0,0,0,0,0,0,20240302,3-6,심야
6:00 ~ 8:59,0,0,0,0,0,0,20240302,6-9,심야
9:00 ~ 11:59,584,584,1228,3295,91635790,4523,20240302,9-12,주간
12:00 ~ 14:59,1233,1233,6209,9186,612411370,15395,20240302,12-15,주간
15:00 ~ 17:59,1413,1413,5215,9399,348358810,14614,20240302,15-18,주간
18:00 ~ 20:59,1963,1963,9804,11260,836534220,21064,20240302,18-21,저녁
21:00 ~ 23:59,12,12,23,34,1067600,57,20240302,21-24,저녁
합계,5205,5205,22479,33174,1890007790,55653,20240302,,
00:00 ~ 2:59,0,0,0,0,0,0,20240303,0-3,심야
3:00 ~ 5:59,0,0,0,0,0,0,20240303,3-6,심야
6:00 ~ 8:59,0,0,0,0,0,0,20240303,6-9,심야
9:00 ~ 11:59,547,547,1272,2520,79363310,3792,20240303,9-12,주간
12:00 ~ 14:59,1148,1148,5346,7472,541448420,12818,20240303,12-15,주간
15:00 ~ 17:59,1312,1312,3308,7472,302763290,10780,20240303,15-18,주간
18:00 ~ 20:59,1912,1912,8591,8476,710125480,17067,20240303,18-21,저녁
21:00 ~ 23:59,11,11,17,20,994100,37,20240303,21-24,저녁
합계,4930,4930,18534,25960,1634694600,44494,20240303,,
00:00 ~ 2:59,0,0,0,0,0,0,20240304,0-3,심야
3:00 ~ 5:59,0,0,0,0,0,0,20240304,3-6,심야
6:00 ~ 8:59,0,0,0,0,0,0,20240304,6-9,심야
9:00 ~ 11:59,491,491,1110,2994,94020600,4104,20240304,9-12,주간
12:00 ~ 14:59,1086,1086,5118,8337,633897170,13455,20240304,12-15,주간
15:00 ~ 17:59,1329,1329,4205,12429,762690490,16634,20240304,15-18,주간
18:00 ~ 20:59,2154,2154,12531,23928,1325214160,36459,20240304,18-21,저녁
21:00 ~ 23:59,10,10,36,-2,-87400,34,20240304,21-24,저녁
합계,5070,5070,23000,47686,2815735020,70686,20240304,,
00:00 ~ 2:59,1,1,0,1,30000,1,20240305,0-3,심야
3:00 ~ 5:59,0,0,0,0,0,0,20240305,3-6,심야
6:00 ~ 8:59,1,1,0,1,30000,1,20240305,6-9,심야
9:00 ~ 11:59,544,544,1126,4518,119592690,5644,20240305,9-12,주간
12:00 ~ 14:59,1164,1164,8007,14617,943938910,22624,20240305,12-15,주간
15:00 ~ 17:59,1425,1425,6046,12664,734854000,18710,20240305,15-18,주간
18:00 ~ 20:59,2344,2344,20120,33212,1767311940,53332,20240305,18-21,저녁
21:00 ~ 23:59,18,18,46,28,762000,74,20240305,21-24,저녁
합계,5497,5497,35345,65041,3566519540,100386,20240305,,
00:00 ~ 2:59,0,0,0,0,0,0,20240306,0-3,심야
3:00 ~ 5:59,0,0,0,0,0,0,20240306,3-6,심야
6:00 ~ 8:59,1,1,0,4,120000,4,20240306,6-9,심야
9:00 ~ 11:59,582,582,1485,3441,96673930,4926,20240306,9-12,주간
12:00 ~ 14:59,1238,1238,8009,16990,1254584830,24999,20240306,12-15,주간
15:00 ~ 17:59,1451,1451,6681,35776,4032516770,42457,20240306,15-18,주간
18:00 ~ 20:59,2417,2417,19479,51919,5295777960,71398,20240306,18-21,저녁
21:00 ~ 23:59,16,16,23,25,500100,48,20240306,21-24,저녁
합계,5705,5705,35677,108155,10680173590,143832,20240306,,
00:00 ~ 2:59,1,1,0,2,60000,2,20240307,0-3,심야
3:00 ~ 5:59,0,0,0,0,0,0,20240307,3-6,심야
6:00 ~ 8:59,0,0,0,0,0,0,20240307,6-9,심야
9:00 ~ 11:59,589,589,1501,6464,107133980,7965,20240307,9-12,주간
12:00 ~ 14:59,1313,1313,6978,14253,1052504680,21231,20240307,12-15,주간
15:00 ~ 17:59,1514,1514,6546,19550,1249785780,26096,20240307,15-18,주간
18:00 ~ 20:59,2400,2400,17608,33598,2666149740,51206,20240307,18-21,저녁
21:00 ~ 23:59,17,17,25,54,1675900,79,20240307,21-24,저녁
합계,5834,5834,32658,73921,5077310080,106579,20240307,,
00:00 ~ 2:59,0,0,0,0,0,0,20240308,0-3,심야
3:00 ~ 5:59,0,0,0,0,0,0,20240308,3-6,심야
6:00 ~ 8:59,0,0,0,0,0,0,20240308,6-9,심야
9:00 ~ 11:59,603,603,1031,4122,108939960,5153,20240308,9-12,주간
12:00 ~ 14:59,1382,1382,6795,13219,757299362,20014,20240308,12-15,주간
15:00 ~ 17:59,1578,1578,6442,13254,665373650,19696,20240308,15-18,주간
18:00 ~ 20:59,2379,2379,16106,27844,1910269629,43950,20240308,18-21,저녁
21:00 ~ 23:59,17,17,15,128,3893000,143,20240308,21-24,저녁
합계,5959,5959,30389,58567,3445775601,88956,20240308,,
00:00 ~ 2:59,0,0,0,0,0,0,20240309,0-3,심야
3:00 ~ 5:59,0,0,0,0,0,0,20240309,3-6,심야
6:00 ~ 8:59,0,0,0,0,0,0,20240309,6-9,심야
9:00 ~ 11:59,623,623,1006,3876,108917240,4882,20240309,9-12,주간
12:00 ~ 14:59,1374,1374,5703,12259,826995710,17962,20240309,12-15,주간
15:00 ~ 17:59,1485,1485,6417,13481,499987410,19898,20240309,15-18,주간
18:00 ~ 20:59,2120,2120,11289,16907,1473746830,28196,20240309,18-21,저녁
21:00 ~ 23:59,15,15,39,78,1801500,117,20240309,21-24,저녁
합계,5617,5617,24454,46601,2911448690,71055,20240309,,
00:00 ~ 2:59,0,0,0,0,0,0,20240310,0-3,심야
3:00 ~ 5:59,0,0,0,0,0,0,20240310,3-6,심야
6:00 ~ 8:59,0,0,0,0,0,0,20240310,6-9,심야
9:00 ~ 11:59,576,576,919,3085,95869350,4004,20240310,9-12,주간
12:00 ~ 14:59,1273,1273,5432,10171,687396780,15603,20240310,12-15,주간
15:00 ~ 17:59,1413,1413,5542,8520,393995680,14062,20240310,15-18,주간
18:00 ~ 20:59,2093,2093,9958,12267,1067011740,22225,20240310,18-21,저녁
21:00 ~ 23:59,22,22,27,89,2402450,116,20240310,21-24,저녁
합계,5377,5377,21878,34132,2246676000,56010,20240310,,
00:00 ~ 2:59,0,0,0,0,0,0,20240311,0-3,심야
3:00 ~ 5:59,0,0,0,0,0,0,20240311,3-6,심야
6:00 ~ 8:59,0,0,0,0,0,0,20240311,6-9,심야
9:00 ~ 11:59,575,575,1157,2824,86670470,3981,20240311,9-12,주간
12:00 ~ 14:59,1223,1223,4944,8798,656558060,13742,20240311,12-15,주간
15:00 ~ 17:59,1436,1436,6990,13119,1028806550,20109,20240311,15-18,주간
18:00 ~ 20:59,2294,2294,13723,25639,1396813410,39362,20240311,18-21,저녁
21:00 ~ 23:59,16,16,34,50,1680000,84,20240311,21-24,저녁
합계,5544,5544,26848,50430,3170528490,77278,20240311,,
00:00 ~ 2:59,0,0,0,0,0,0,20240312,0-3,심야
3:00 ~ 5:59,0,0,0,0,0,0,20240312,3-6,심야
6:00 ~ 8:59,0,0,0,0,0,0,20240312,6-9,심야
9:00 ~ 11:59,619,619,1643,4785,146973840,6428,20240312,9-12,주간
12:00 ~ 14:59,1257,1257,6037,11856,722480000,17893,20240312,12-15,주간
15:00 ~ 17:59,1484,1484,8407,29674,2643162730,38081,20240312,15-18,주간
18:00 ~ 20:59,2378,2378,17101,36421,2681482620,53522,20240312,18-21,저녁
21:00 ~ 23:59,18,18,35,48,1285100,83,20240312,21-24,저녁
합계,5756,5756,33223,82784,6195384290,116007,20240312,,
00:00 ~ 2:59,0,0,0,0,0,0,20240313,0-3,심야
3:00 ~ 5:59,0,0,0,0,0,0,20240313,3-6,심야
6:00 ~ 8:59,0,0,0,0,0,0,20240313,6-9,심야
9:00 ~ 11:59,695,695,1892,5782,129781810,7674,20240313,9-12,주간
12:00 ~ 14:59,1343,1343,5838,12117,858614170,17955,20240313,12-15,주간
15:00 ~ 17:59,1523,1523,8350,19396,1331272220,27746,20240313,15-18,주간
18:00 ~ 20:59,2414,2414,16013,32787,2182261250,48800,20240313,18-21,저녁
21:00 ~ 23:59,22,22,58,104,3079600,162,20240313,21-24,저녁
합계,5997,5997,32151,70186,4505009050,102337,20240313,,
00:00 ~ 2:59,0,0,0,0,0,0,20240314,0-3,심야
3:00 ~ 5:59,1,1,0,1,30000,1,20240314,3-6,심야
6:00 ~ 8:59,0,0,0,0,0,0,20240314,6-9,심야
9:00 ~ 11:59,682,682,2681,7215,204376350,9896,20240314,9-12,주간
12:00 ~ 14:59,1304,1304,5845,13697,873375100,19542,20240314,12-15,주간
15:00 ~ 17:59,1551,1551,9519,17841,1522944510,27360,20240314,15-18,주간
18:00 ~ 20:59,2417,2417,14135,28116,1396558480,42251,20240314,18-21,저녁
21:00 ~ 23:59,19,19,44,53,1441600,97,20240314,21-24,저녁
합계,5974,5974,32224,66923,3998726040,99147,20240314,,
00:00 ~ 2:59,0,0,0,0,0,0,20240315,0-3,심야
3:00 ~ 5:59,0,0,0,0,0,0,20240315,3-6,심야
6:00 ~ 8:59,0,0,0,0,0,0,20240315,6-9,심야
9:00 ~ 11:59,676,676,1851,9478,141149460,11329,20240315,9-12,주간
12:00 ~ 14:59,1430,1430,11984,12754,873343800,24738,20240315,12-15,주간
15:00 ~ 17:59,1618,1618,9148,16459,864666740,25607,20240315,15-18,주간
18:00 ~ 20:59,2439,2439,19985,28129,1758388090,48114,20240315,18-21,저녁
21:00 ~ 23:59,17,17,87,89,4653000,176,20240315,21-24,저녁
합계,6180,6180,43055,66909,3642201090,109964,20240315,,
00:00 ~ 2:59,0,0,0,0,0,0,20240316,0-3,심야
3:00 ~ 5:59,0,0,0,0,0,0,20240316,3-6,심야
6:00 ~ 8:59,0,0,0,0,0,0,20240316,6-9,심야
9:00 ~ 11:59,640,640,1286,7145,109004760,8431,20240316,9-12,주간
12:00 ~ 14:59,1378,1378,7415,11046,651579384,18461,20240316,12-15,주간
15:00 ~ 17:59,1548,1548,7566,12508,476545655,20074,20240316,15-18,주간
18:00 ~ 20:59,2146,2146,11931,11385,890861470,23316,20240316,18-21,저녁
21:00 ~ 23:59,18,18,28,68,3783500,96,20240316,21-24,저녁
합계,5730,5730,28226,42152,2131774769,70378,20240316,,
00:00 ~ 2:59,1,1,0,2,60000,2,20240317,0-3,심야
3:00 ~ 5:59,0,0,0,0,0,0,20240317,3-6,심야
6:00 ~ 8:59,1,1,0,2,60000,2,20240317,6-9,심야
9:00 ~ 11:59,607,607,970,2955,96321580,3925,20240317,9-12,주간
12:00 ~ 14:59,1282,1282,8036,6394,562910402,14430,20240317,12-15,주간
15:00 ~ 17:59,1442,1442,5473,8769,411727170,14242,20240317,15-18,주간
18:00 ~ 20:59,2140,2140,11422,8325,684476110,19747,20240317,18-21,저녁
21:00 ~ 23:59,17,17,43,54,2747500,97,20240317,21-24,저녁
합계,5490,5490,25944,26501,1758302762,52445,20240317,,
00:00 ~ 2:59,0,0,0,0,0,0,20240318,0-3,심야
3:00 ~ 5:59,0,0,0,0,0,0,20240318,3-6,심야
6:00 ~ 8:59,0,0,0,0,0,0,20240318,6-9,심야
9:00 ~ 11:59,639,639,1145,3808,87137200,4953,20240318,9-12,주간
12:00 ~ 14:59,1267,1267,6311,15478,770701295,21789,20240318,12-15,주간
15:00 ~ 17:59,1478,1478,5922,9656,323970625,15578,20240318,15-18,주간
18:00 ~ 20:59,2346,2346,14787,29077,2274259944,43864,20240318,18-21,저녁
21:00 ~ 23:59,15,15,40,50,1587600,90,20240318,21-24,저녁
합계,5745,5745,28205,58069,3457656664,86274,20240318,,
00:00 ~ 2:59,0,0,0,0,0,0,20240319,0-3,심야
3:00 ~ 5:59,0,0,0,0,0,0,20240319,3-6,심야
6:00 ~ 8:59,0,0,0,0,0,0,20240319,6-9,심야
9:00 ~ 11:59,651,651,1330,3957,101990560,5287,20240319,9-12,주간
12:00 ~ 14:59,1335,1335,8604,11227,743110060,19831,20240319,12-15,주간
15:00 ~ 17:59,1495,1495,6823,24125,2428734570,30948,20240319,15-18,주간
18:00 ~ 20:59,2407,2407,14525,29804,2133850981,44329,20240319,18-21,저녁
21:00 ~ 23:59,23,23,78,143,4891350,221,20240319,21-24,저녁
합계,5911,5911,31360,69256,5412577521,100616,20240319,,
00:00 ~ 2:59,0,0,0,0,0,0,20240320,0-3,심야
3:00 ~ 5:59,0,0,0,0,0,0,20240320,3-6,심야
6:00 ~ 8:59,0,0,0,0,0,0,20240320,6-9,심야
9:00 ~ 11:59,610,610,1785,3882,102258490,5667,20240320,9-12,주간
12:00 ~ 14:59,1343,1343,5013,8801,527631250,13814,20240320,12-15,주간
15:00 ~ 17:59,1527,1527,6504,11033,540497750,17537,20240320,15-18,주간
18:00 ~ 20:59,2496,2496,16255,21669,1282192660,37924,20240320,18-21,저녁
21:00 ~ 23:59,22,22,68,33,1264200,101,20240320,21-24,저녁
합계,5998,5998,29625,45418,2453844350,75043,20240320,,
00:00 ~ 2:59,0,0,0,0,0,0,20240321,0-3,심야
3:00 ~ 5:59,1,1,0,2,60000,2,20240321,3-6,심야
6:00 ~ 8:59,0,0,0,0,0,0,20240321,6-9,심야
9:00 ~ 11:59,659,659,3049,4746,114313040,7795,20240321,9-12,주간
12:00 ~ 14:59,1359,1359,8261,14800,968029010,23061,20240321,12-15,주간
15:00 ~ 17:59,1625,1625,7991,15486,618594900,23477,20240321,15-18,주간
18:00 ~ 20:59,2506,2506,24493,50163,3938817660,74656,20240321,18-21,저녁
21:00 ~ 23:59,20,20,56,65,2706400,121,20240321,21-24,저녁
합계,6170,6170,43850,85262,5642521010,129112,20240321,,
00:00 ~ 2:59,0,0,0,0,0,0,20240322,0-3,심야
3:00 ~ 5:59,0,0,0,0,0,0,20240322,3-6,심야
6:00 ~ 8:59,2,2,48,518,116920000,566,20240322,6-9,심야
9:00 ~ 11:59,686,686,2302,5803,128600590,8105,20240322,9-12,주간
12:00 ~ 14:59,1488,1488,6522,15265,775791250,21787,20240322,12-15,주간
15:00 ~ 17:59,1669,1669,7522,14316,558750480,21838,20240322,15-18,주간
18:00 ~ 20:59,2492,2492,16179,25872,1181786930,42051,20240322,18-21,저녁
21:00 ~ 23:59,23,23,49,62,2489200,111,20240322,21-24,저녁
합계,6360,6360,32622,61836,2764338450,94458,20240322,,
00:00 ~ 2:59,0,0,0,0,0,0,20240323,0-3,심야
3:00 ~ 5:59,0,0,0,0,0,0,20240323,3-6,심야
6:00 ~ 8:59,1,1,15,29,5780000,44,20240323,6-9,심야
9:00 ~ 11:59,654,654,1251,4069,117349060,5320,20240323,9-12,주간
12:00 ~ 14:59,1445,1445,5262,10367,660235772,15629,20240323,12-15,주간
15:00 ~ 17:59,1559,1559,6565,11899,410477600,18464,20240323,15-18,주간
18:00 ~ 20:59,2190,2190,11336,10273,748723220,21609,20240323,18-21,저녁
21:00 ~ 23:59,15,15,38,45,1807500,83,20240323,21-24,저녁
합계,5864,5864,24467,36682,1944373152,61149,20240323,,
00:00 ~ 2:59,0,0,0,0,0,0,20240324,0-3,심야
3:00 ~ 5:59,0,0,0,0,0,0,20240324,3-6,심야
6:00 ~ 8:59,2,2,19,29,6270000,48,20240324,6-9,심야
9:00 ~ 11:59,604,604,1103,2623,88238440,3726,20240324,9-12,주간
12:00 ~ 14:59,1311,1311,5330,8233,561032262,13563,20240324,12-15,주간
15:00 ~ 17:59,1396,1396,6653,5459,317058962,12112,20240324,15-18,주간
18:00 ~ 20:59,2103,2103,8636,8993,567473649,17629,20240324,18-21,저녁
21:00 ~ 23:59,19,19,50,24,1169500,74,20240324,21-24,저녁
합계,5435,5435,21791,25361,1541242813,47152,20240324,,
00:00 ~ 2:59,1,1,0,3,90000,3,20240325,0-3,심야
3:00 ~ 5:59,0,0,0,0,0,0,20240325,3-6,심야
6:00 ~ 8:59,1,1,23,3,400000,26,20240325,6-9,심야
9:00 ~ 11:59,619,619,1163,3111,89674740,4274,20240325,9-12,주간
12:00 ~ 14:59,1207,1207,5965,10807,976946668,16772,20240325,12-15,주간
15:00 ~ 17:59,1408,1408,6055,20252,1938320950,26307,20240325,15-18,주간
18:00 ~ 20:59,2328,2328,16121,37719,4333033204,53840,20240325,18-21,저녁
21:00 ~ 23:59,18,18,93,-3,198100,90,20240325,21-24,저녁
합계,5582,5582,29420,71892,7338663662,101312,20240325,,
00:00 ~ 2:59,0,0,0,0,0,0,20240326,0-3,심야
3:00 ~ 5:59,1,1,0,1,30000,1,20240326,3-6,심야
6:00 ~ 8:59,1,1,33,4,580000,37,20240326,6-9,심야
9:00 ~ 11:59,598,598,1872,4152,105336140,6024,20240326,9-12,주간
12:00 ~ 14:59,1345,1345,6945,15979,956387180,22924,20240326,12-15,주간
15:00 ~ 17:59,1541,1541,5835,16360,871496850,22195,20240326,15-18,주간
18:00 ~ 20:59,2523,2523,18791,36135,2661712291,54926,20240326,18-21,저녁
21:00 ~ 23:59,18,18,86,19,1522100,105,20240326,21-24,저녁
합계,6027,6027,33562,72650,4597064561,106212,20240326,,
00:00 ~ 2:59,1,1,0,1,30000,1,20240327,0-3,심야
3:00 ~ 5:59,2,2,0,300,0,300,20240327,3-6,심야
6:00 ~ 8:59,1,1,16,2,140000,18,20240327,6-9,심야
9:00 ~ 11:59,644,644,1134,5538,94246790,6672,20240327,9-12,주간
12:00 ~ 14:59,1348,1348,8453,15380,1294790840,23833,20240327,12-15,주간
15:00 ~ 17:59,1530,1530,6845,33707,3763962771,40552,20240327,15-18,주간
18:00 ~ 20:59,2509,2509,21204,50567,4928787220,71771,20240327,18-21,저녁
21:00 ~ 23:59,22,22,62,56,2094200,118,20240327,21-24,저녁
합계,6057,6057,37714,105551,10084051821,143265,20240327,,
00:00 ~ 2:59,1,1,0,1,30000,1,20240328,0-3,심야
3:00 ~ 5:59,6,6,0,238,60000,238,20240328,3-6,심야
6:00 ~ 8:59,1,1,20,-5,-2310000,15,20240328,6-9,심야
9:00 ~ 11:59,626,626,1604,5450,105748571,7054,20240328,9-12,주간
12:00 ~ 14:59,1381,1381,14107,17174,1246625389,31281,20240328,12-15,주간
15:00 ~ 17:59,1597,1597,7351,18689,1380101460,26040,20240328,15-18,주간
18:00 ~ 20:59,2552,2552,19936,35984,2398113330,55920,20240328,18-21,저녁
21:00 ~ 23:59,19,19,55,29,1527000,84,20240328,21-24,저녁
합계,6183,6183,43073,77560,5129895750,120633,20240328,,
00:00 ~ 2:59,2,2,0,3,90000,3,20240329,0-3,심야
3:00 ~ 5:59,0,0,0,0,0,0,20240329,3-6,심야
6:00 ~ 8:59,2,2,29,-5,-1165000,24,20240329,6-9,심야
9:00 ~ 11:59,670,670,1829,4161,99525860,5990,20240329,9-12,주간
12:00 ~ 14:59,1446,1446,8731,18340,1278209640,27071,20240329,12-15,주간
15:00 ~ 17:59,1566,1566,8352,15739,720084320,24091,20240329,15-18,주간
18:00 ~ 20:59,2425,2425,19972,26360,1423632200,46332,20240329,18-21,저녁
21:00 ~ 23:59,25,25,107,129,3374600,236,20240329,21-24,저녁
합계,6136,6136,39020,64727,3523751620,103747,20240329,,
00:00 ~ 2:59,0,0,0,0,0,0,20240330,0-3,심야
3:00 ~ 5:59,1,1,0,1,30000,1,20240330,3-6,심야
6:00 ~ 8:59,1,1,16,-6,-2800000,10,20240330,6-9,심야
9:00 ~ 11:59,671,671,1161,3369,101638110,4530,20240330,9-12,주간
12:00 ~ 14:59,1466,1466,6332,10385,730968020,16717,20240330,12-15,주간
15:00 ~ 17:59,1577,1577,9447,8947,540021470,18394,20240330,15-18,주간
18:00 ~ 20:59,2217,2217,13059,11436,949767430,24495,20240330,18-21,저녁
21:00 ~ 23:59,16,16,102,82,2360100,184,20240330,21-24,저녁
합계,5949,5949,30117,34214,2321985130,64331,20240330,,
00:00 ~ 2:59,0,0,0,0,0,0,20240331,0-3,심야
3:00 ~ 5:59,0,0,0,0,0,0,20240331,3-6,심야
6:00 ~ 8:59,1,1,11,1,140000,12,20240331,6-9,심야
9:00 ~ 11:59,579,579,949,2469,82574170,3418,20240331,9-12,주간
12:00 ~ 14:59,1308,1308,7584,6956,591710640,14540,20240331,12-15,주간
15:00 ~ 17:59,1397,1397,5271,7086,371602410,12357,20240331,15-18,주간
18:00 ~ 20:59,2117,2117,11546,9516,716082940,21062,20240331,18-21,저녁
21:00 ~ 23:59,17,17,33,79,2973400,112,20240331,21-24,저녁
합계,5419,5419,25394,26107,1765083560,51501,20240331,,
00:00 ~ 2:59,0,0,0,0,0,0,20240401,0-3,심야
3:00 ~ 5:59,0,0,0,0,0,0,20240401,3-6,심야
6:00 ~ 8:59,1,1,22,-7,-1760000,15,20240401,6-9,심야
9:00 ~ 11:59,630,630,1063,2695,94515540,3758,20240401,9-12,주간
12:00 ~ 14:59,1320,1320,6479,11340,902430010,17819,20240401,12-15,주간
15:00 ~ 17:59,1524,1524,5960,11797,865963470,17757,20240401,15-18,주간
18:00 ~ 20:59,2411,2411,15723,22919,1398075603,38642,20240401,18-21,저녁
21:00 ~ 23:59,17,17,120,120,4723000,240,20240401,21-24,저녁
합계,5903,5903,29367,48864,3263947623,78231,20240401,,
00:00 ~ 2:59,0,0,0,0,0,0,20240402,0-3,심야
3:00 ~ 5:59,0,0,0,0,0,0,20240402,3-6,심야
6:00 ~ 8:59,1,1,4,3,855000,7,20240402,6-9,심야
9:00 ~ 11:59,613,613,1423,3934,119314410,5357,20240402,9-12,주간
12:00 ~ 14:59,1382,1382,8808,15735,1311119650,24543,20240402,12-15,주간
15:00 ~ 17:59,1526,1526,6354,15102,1002350210,21456,20240402,15-18,주간
18:00 ~ 20:59,2460,2460,26256,91033,10988734480,117289,20240402,18-21,저녁
21:00 ~ 23:59,17,17,248,33,3170000,281,20240402,21-24,저녁
합계,5999,5999,43093,125840,13425543750,168933,20240402,,
00:00 ~ 2:59,0,0,0,0,0,0,20240403,0-3,심야
3:00 ~ 5:59,0,0,0,0,0,0,20240403,3-6,심야
6:00 ~ 8:59,1,1,18,-6,-1560000,12,20240403,6-9,심야
9:00 ~ 11:59,624,624,1419,3265,96396050,4684,20240403,9-12,주간
12:00 ~ 14:59,1389,1389,10494,12999,1063293200,23493,20240403,12-15,주간
15:00 ~ 17:59,1546,1546,6511,10357,570063720,16868,20240403,15-18,주간
18:00 ~ 20:59,2450,2450,20049,20841,1285577740,40890,20240403,18-21,저녁
21:00 ~ 23:59,20,20,138,191,3385600,329,20240403,21-24,저녁
합계,6030,6030,38629,47647,3017156310,86276,20240403,,
00:00 ~ 2:59,0,0,0,0,0,0,20240404,0-3,심야
3:00 ~ 5:59,0,0,0,0,0,0,20240404,3-6,심야
6:00 ~ 8:59,1,1,11,3,85000,14,20240404,6-9,심야
9:00 ~ 11:59,625,625,2105,4592,103900800,6697,20240404,9-12,주간
12:00 ~ 14:59,1436,1436,9056,14067,1102815270,23123,20240404,12-15,주간
15:00 ~ 17:59,1499,1499,6754,10385,603716680,17139,20240404,15-18,주간
18:00 ~ 20:59,2456,2456,22486,27263,2147876800,49749,20240404,18-21,저녁
21:00 ~ 23:59,19,19,233,139,5644900,372,20240404,21-24,저녁
합계,6036,6036,40645,56449,3964039450,97094,20240404,,
00:00 ~ 2:59,0,0,0,0,0,0,20240405,0-3,심야
3:00 ~ 5:59,0,0,0,0,0,0,20240405,3-6,심야
6:00 ~ 8:59,1,1,9,-2,-828000,7,20240405,6-9,심야
9:00 ~ 11:59,640,640,2010,3919,93871610,5929,20240405,9-12,주간
12:00 ~ 14:59,1425,1425,7497,12624,753603250,20121,20240405,12-15,주간
15:00 ~ 17:59,1548,1548,6727,13843,837847990,20570,20240405,15-18,주간
18:00 ~ 20:59,2323,2323,16436,25870,1470948820,42306,20240405,18-21,저녁
21:00 ~ 23:59,16,16,152,118,4310800,270,20240405,21-24,저녁
합계,5953,5953,32831,56372,3159754470,89203,20240405,,
00:00 ~ 2:59,0,0,0,0,0,0,20240406,0-3,심야
3:00 ~ 5:59,0,0,0,0,0,0,20240406,3-6,심야
6:00 ~ 8:59,1,1,2,-1,-300000,1,20240406,6-9,심야
9:00 ~ 11:59,614,614,1336,2926,96731680,4262,20240406,9-12,주간
12:00 ~ 14:59,1423,1423,6987,9246,685012790,16233,20240406,12-15,주간
15:00 ~ 17:59,1457,1457,6635,8048,393443460,14683,20240406,15-18,주간
18:00 ~ 20:59,2081,2081,11733,11086,934285740,22819,20240406,18-21,저녁
21:00 ~ 23:59,12,12,153,115,3294500,268,20240406,21-24,저녁
합계,5588,5588,26846,31420,2112468170,58266,20240406,,
00:00 ~ 2:59,0,0,0,0,0,0,20240407,0-3,심야
3:00 ~ 5:59,0,0,0,0,0,0,20240407,3-6,심야
6:00 ~ 8:59,1,1,9,3,725000,12,20240407,6-9,심야
9:00 ~ 11:59,546,546,1061,2350,89407060,3411,20240407,9-12,주간
12:00 ~ 14:59,1301,1301,6787,8716,704797050,15503,20240407,12-15,주간
15:00 ~ 17:59,1339,1339,4188,7067,289347980,11255,20240407,15-18,주간
18:00 ~ 20:59,1963,1963,9031,10770,640233370,19801,20240407,18-21,저녁
21:00 ~ 23:59,10,10,11,36,890400,47,20240407,21-24,저녁
합계,5160,5160,21087,28942,1725400860,50029,20240407,,
00:00 ~ 2:59,0,0,0,0,0,0,20240408,0-3,심야
3:00 ~ 5:59,0,0,0,0,0,0,20240408,3-6,심야
6:00 ~ 8:59,1,1,36,-12,-2432000,24,20240408,6-9,심야
9:00 ~ 11:59,620,620,1189,3803,97336510,4992,20240408,9-12,주간
12:00 ~ 14:59,1304,1304,6439,12511,859158640,18950,20240408,12-15,주간
15:00 ~ 17:59,1418,1418,5829,10932,687767780,16761,20240408,15-18,주간
18:00 ~ 20:59,2255,2255,16510,41621,3651974362,58131,20240408,18-21,저녁
21:00 ~ 23:59,7,7,9,24,1058300,33,20240408,21-24,저녁
합계,5605,5605,30012,68879,5294863592,98891,20240408,,
00:00 ~ 2:59,0,0,0,0,0,0,20240409,0-3,심야
3:00 ~ 5:59,0,0,0,0,0,0,20240409,3-6,심야
6:00 ~ 8:59,1,1,24,-3,-380000,21,20240409,6-9,심야
9:00 ~ 11:59,650,650,1437,4626,125439620,6063,20240409,9-12,주간
12:00 ~ 14:59,1364,1364,6636,14075,916957410,20711,20240409,12-15,주간
15:00 ~ 17:59,1507,1507,6644,21738,1832905020,28382,20240409,15-18,주간
18:00 ~ 20:59,2310,2310,20060,38996,3175770200,59056,20240409,18-21,저녁
21:00 ~ 23:59,12,12,6,40,1315250,46,20240409,21-24,저녁
합계,5844,5844,34807,79472,6052007500,114279,20240409,,
00:00 ~ 2:59,0,0,0,0,0,0,20240410,0-3,심야
3:00 ~ 5:59,0,0,0,0,0,0,20240410,3-6,심야
6:00 ~ 8:59,0,0,0,0,0,0,20240410,6-9,심야
9:00 ~ 11:59,582,582,913,2517,89834890,3430,20240410,9-12,주간
12:00 ~ 14:59,1334,1334,9421,9738,610050940,19159,20240410,12-15,주간
15:00 ~ 17:59,1465,1465,5559,7181,431879240,12740,20240410,15-18,주간
18:00 ~ 20:59,2172,2172,16388,104867,16606039740,121255,20240410,18-21,저녁
21:00 ~ 23:59,11,11,9,29,801000,38,20240410,21-24,저녁
합계,5564,5564,32290,124332,17738605810,156622,20240410,,
00:00 ~ 2:59,0,0,0,0,0,0,20240411,0-3,심야
3:00 ~ 5:59,0,0,0,0,0,0,20240411,3-6,심야
6:00 ~ 8:59,0,0,0,0,0,0,20240411,6-9,심야
9:00 ~ 11:59,686,686,1982,5714,122628230,7696,20240411,9-12,주간
12:00 ~ 14:59,1389,1389,8159,13438,910314780,21597,20240411,12-15,주간
15:00 ~ 17:59,1574,1574,9345,18071,1803317030,27416,20240411,15-18,주간
18:00 ~ 20:59,2405,2405,24727,37920,3944982210,62647,20240411,18-21,저녁
21:00 ~ 23:59,14,14,16,28,960100,44,20240411,21-24,저녁
합계,6068,6068,44229,75171,6782202350,119400,20240411,,
00:00 ~ 2:59,0,0,0,0,0,0,20240412,0-3,심야
3:00 ~ 5:59,0,0,0,0,0,0,20240412,3-6,심야
6:00 ~ 8:59,0,0,0,0,0,0,20240412,6-9,심야
9:00 ~ 11:59,710,710,2285,5558,164846850,7843,20240412,9-12,주간
12:00 ~ 14:59,1484,1484,7859,17076,969340551,24935,20240412,12-15,주간
15:00 ~ 17:59,1559,1559,7878,16523,1179778060,24401,20240412,15-18,주간
18:00 ~ 20:59,2385,2385,17827,37168,2918999000,54995,20240412,18-21,저녁
21:00 ~ 23:59,9,9,11,32,1188050,43,20240412,21-24,저녁
합계,6147,6147,35860,76357,5234152511,112217,20240412,,
00:00 ~ 2:59,0,0,0,0,0,0,20240413,0-3,심야
3:00 ~ 5:59,0,0,0,0,0,0,20240413,3-6,심야
6:00 ~ 8:59,0,0,0,0,0,0,20240413,6-9,심야
9:00 ~ 11:59,662,662,1223,2882,97577280,4105,20240413,9-12,주간
12:00 ~ 14:59,1370,1370,9598,7487,681342531,17085,20240413,12-15,주간
15:00 ~ 17:59,1512,1512,7086,9338,409860370,16424,20240413,15-18,주간
18:00 ~ 20:59,2133,2133,12997,11435,1025198531,24432,20240413,18-21,저녁
21:00 ~ 23:59,11,11,3,41,1686400,44,20240413,21-24,저녁
합계,5688,5688,30907,31183,2215665112,62090,20240413,,
00:00 ~ 2:59,0,0,0,0,0,0,20240414,0-3,심야
3:00 ~ 5:59,0,0,0,0,0,0,20240414,3-6,심야
6:00 ~ 8:59,0,0,0,0,0,0,20240414,6-9,심야
9:00 ~ 11:59,581,581,1183,2513,93589710,3696,20240414,9-12,주간
12:00 ~ 14:59,1303,1303,6668,7394,553469510,14062,20240414,12-15,주간
15:00 ~ 17:59,1401,1401,4681,7588,308726600,12269,20240414,15-18,주간
18:00 ~ 20:59,2053,2053,12110,8394,646638210,20504,20240414,18-21,저녁
21:00 ~ 23:59,11,11,17,31,1555800,48,20240414,21-24,저녁
합계,5349,5349,24659,25920,1603979830,50579,20240414,,
00:00 ~ 2:59,0,0,0,0,0,0,20240415,0-3,심야
3:00 ~ 5:59,0,0,0,0,0,0,20240415,3-6,심야
6:00 ~ 8:59,0,0,0,0,0,0,20240415,6-9,심야
9:00 ~ 11:59,606,606,1597,4499,128969940,6096,20240415,9-12,주간
12:00 ~ 14:59,1279,1279,8220,10417,534498349,18637,20240415,12-15,주간
15:00 ~ 17:59,1451,1451,5615,10527,562318810,16142,20240415,15-18,주간
18:00 ~ 20:59,2322,2322,13086,23241,1595495870,36327,20240415,18-21,저녁
21:00 ~ 23:59,12,12,16,21,965100,37,20240415,21-24,저녁
합계,5670,5670,28534,48705,2822248069,77239,20240415,,
00:00 ~ 2:59,0,0,0,0,0,0,20240416,0-3,심야
3:00 ~ 5:59,0,0,0,0,0,0,20240416,3-6,심야
6:00 ~ 8:59,0,0,0,0,0,0,20240416,6-9,심야
9:00 ~ 11:59,672,672,2883,4578,133124200,7461,20240416,9-12,주간
12:00 ~ 14:59,1348,1348,7200,14353,971219730,21553,20240416,12-15,주간
15:00 ~ 17:59,1535,1535,6554,17369,1472331330,23923,20240416,15-18,주간
18:00 ~ 20:59,2451,2451,22207,38301,2966796680,60508,20240416,18-21,저녁
21:00 ~ 23:59,12,12,8,31,1382000,39,20240416,21-24,저녁
합계,6018,6018,38852,74632,5544853940,113484,20240416,,
00:00 ~ 2:59,0,0,0,0,0,0,20240417,0-3,심야
3:00 ~ 5:59,0,0,0,0,0,0,20240417,3-6,심야
6:00 ~ 8:59,0,0,0,0,0,0,20240417,6-9,심야
9:00 ~ 11:59,642,642,2092,5800,133702800,7892,20240417,9-12,주간
12:00 ~ 14:59,1393,1393,7420,17770,1675106110,25190,20240417,12-15,주간
15:00 ~ 17:59,1636,1636,8855,17570,945705250,26425,20240417,15-18,주간
18:00 ~ 20:59,2511,2511,19394,27868,2074486650,47262,20240417,18-21,저녁
21:00 ~ 23:59,12,12,17,40,2033000,57,20240417,21-24,저녁
합계,6194,6194,37778,69048,4831033810,106826,20240417,,
00:00 ~ 2:59,0,0,0,0,0,0,20240418,0-3,심야
3:00 ~ 5:59,0,0,0,0,0,0,20240418,3-6,심야
6:00 ~ 8:59,0,0,0,0,0,0,20240418,6-9,심야
9:00 ~ 11:59,714,714,2345,7378,134514250,9723,20240418,9-12,주간
12:00 ~ 14:59,1422,1422,8755,15619,1112621870,24374,20240418,12-15,주간
15:00 ~ 17:59,1567,1567,7258,15029,587013560,22287,20240418,15-18,주간
18:00 ~ 20:59,2426,2426,23372,31703,1544871380,55075,20240418,18-21,저녁
21:00 ~ 23:59,10,10,10,30,924950,40,20240418,21-24,저녁
합계,6139,6139,41740,69759,3379946010,111499,20240418,,
00:00 ~ 2:59,0,0,0,0,0,0,20240419,0-3,심야
3:00 ~ 5:59,0,0,0,0,0,0,20240419,3-6,심야
6:00 ~ 8:59,0,0,0,0,0,0,20240419,6-9,심야
9:00 ~ 11:59,712,712,2465,9021,792403260,11486,20240419,9-12,주간
12:00 ~ 14:59,1470,1470,6991,14186,747375630,21177,20240419,12-15,주간
15:00 ~ 17:59,1647,1647,8498,17950,1051688850,26448,20240419,15-18,주간
18:00 ~ 20:59,2436,2436,18047,29289,1659021790,47336,20240419,18-21,저녁
21:00 ~ 23:59,7,7,12,38,1428000,50,20240419,21-24,저녁
합계,6272,6272,36013,70484,4251917530,106497,20240419,,
00:00 ~ 2:59,0,0,0,0,0,0,20240420,0-3,심야
3:00 ~ 5:59,0,0,0,0,0,0,20240420,3-6,심야
6:00 ~ 8:59,0,0,0,0,0,0,20240420,6-9,심야
9:00 ~ 11:59,660,660,1265,3843,184031400,5108,20240420,9-12,주간
12:00 ~ 14:59,1469,1469,6653,10494,651559810,17147,20240420,12-15,주간
15:00 ~ 17:59,1590,1590,7443,13024,628772250,20467,20240420,15-18,주간
18:00 ~ 20:59,2090,2090,12857,12642,995345030,25499,20240420,18-21,저녁
21:00 ~ 23:59,11,11,4,57,2030100,61,20240420,21-24,저녁
합계,5820,5820,28222,40060,2461738590,68282,20240420,,
00:00 ~ 2:59,0,0,0,0,0,0,20240421,0-3,심야
3:00 ~ 5:59,0,0,0,0,0,0,20240421,3-6,심야
6:00 ~ 8:59,0,0,0,0,0,0,20240421,6-9,심야
9:00 ~ 11:59,600,600,1153,2695,97214500,3848,20240421,9-12,주간
12:00 ~ 14:59,1329,1329,6479,7945,569650880,14424,20240421,12-15,주간
15:00 ~ 17:59,1404,1404,5492,9498,673409470,14990,20240421,15-18,주간
18:00 ~ 20:59,2051,2051,10621,12231,1095518749,22852,20240421,18-21,저녁
21:00 ~ 23:59,8,8,11,23,1345000,34,20240421,21-24,저녁
합계,5392,5392,23756,32392,2437138599,56148,20240421,,
00:00 ~ 2:59,0,0,0,0,0,0,20240422,0-3,심야
3:00 ~ 5:59,0,0,0,0,0,0,20240422,3-6,심야
6:00 ~ 8:59,0,0,0,0,0,0,20240422,6-9,심야
9:00 ~ 11:59,675,675,1950,3741,107853000,5691,20240422,9-12,주간
12:00 ~ 14:59,1345,1345,5753,9201,572013865,14954,20240422,12-15,주간
15:00 ~ 17:59,1482,1482,5855,9815,639291935,15670,20240422,15-18,주간
18:00 ~ 20:59,2274,2274,13132,24682,1044404925,37814,20240422,18-21,저녁
21:00 ~ 23:59,8,8,21,24,1106000,45,20240422,21-24,저녁
합계,5784,5784,26711,47463,2364669725,74174,20240422,,
00:00 ~ 2:59,0,0,0,0,0,0,20240423,0-3,심야
3:00 ~ 5:59,0,0,0,0,0,0,20240423,3-6,심야
6:00 ~ 8:59,0,0,0,0,0,0,20240423,6-9,심야
9:00 ~ 11:59,708,708,3685,5234,124750180,8919,20240423,9-12,주간
12:00 ~ 14:59,1430,1430,7511,16313,909896017,23824,20240423,12-15,주간
15:00 ~ 17:59,1587,1587,8331,27714,3004061220,36045,20240423,15-18,주간
18:00 ~ 20:59,2500,2500,24915,43194,3316319920,68109,20240423,18-21,저녁
21:00 ~ 23:59,10,10,31,1,26200,32,20240423,21-24,저녁
합계,6235,6235,44473,92456,7355053537,136929,20240423,,
00:00 ~ 2:59,0,0,0,0,0,0,20240424,0-3,심야
3:00 ~ 5:59,0,0,0,0,0,0,20240424,3-6,심야
6:00 ~ 8:59,0,0,0,0,0,0,20240424,6-9,심야
9:00 ~ 11:59,705,705,3386,9092,208794890,12478,20240424,9-12,주간
12:00 ~ 14:59,1453,1453,7117,17115,1090708535,24232,20240424,12-15,주간
15:00 ~ 17:59,1566,1566,7830,13865,1191593250,21695,20240424,15-18,주간
18:00 ~ 20:59,2540,2540,21541,35951,2572100562,57492,20240424,18-21,저녁
21:00 ~ 23:59,9,9,15,44,1935200,59,20240424,21-24,저녁
합계,6273,6273,39889,76067,5065132437,115956,20240424,,
00:00 ~ 2:59,0,0,0,0,0,0,20240425,0-3,심야
3:00 ~ 5:59,0,0,0,0,0,0,20240425,3-6,심야
6:00 ~ 8:59,0,0,0,0,0,0,20240425,6-9,심야
9:00 ~ 11:59,754,754,2858,8745,172733540,11603,20240425,9-12,주간
12:00 ~ 14:59,1519,1519,9656,21339,1511147440,30995,20240425,12-15,주간
15:00 ~ 17:59,1618,1618,8232,16717,1295364500,24949,20240425,15-18,주간
18:00 ~ 20:59,2524,2524,29153,45779,3576619970,74932,20240425,18-21,저녁
21:00 ~ 23:59,10,10,10,39,1756650,49,20240425,21-24,저녁
합계,6425,6425,49909,92619,6557622100,142528,20240425,,
00:00 ~ 2:59,0,0,0,0,0,0,20240426,0-3,심야
3:00 ~ 5:59,0,0,0,0,0,0,20240426,3-6,심야
6:00 ~ 8:59,0,0,0,0,0,0,20240426,6-9,심야
9:00 ~ 11:59,798,798,3574,10405,154133930,13979,20240426,9-12,주간
12:00 ~ 14:59,1622,1622,9040,14386,883606400,23426,20240426,12-15,주간
15:00 ~ 17:59,1720,1720,10248,20594,1421187979,30842,20240426,15-18,주간
18:00 ~ 20:59,2542,2542,22267,36706,2245030450,58973,20240426,18-21,저녁
21:00 ~ 23:59,8,8,14,41,1320950,55,20240426,21-24,저녁
합계,6690,6690,45143,82132,4705279709,127275,20240426,,
00:00 ~ 2:59,0,0,0,0,0,0,20240427,0-3,심야
3:00 ~ 5:59,0,0,0,0,0,0,20240427,3-6,심야
6:00 ~ 8:59,0,0,0,0,0,0,20240427,6-9,심야
9:00 ~ 11:59,696,696,2167,2639,91238430,4806,20240427,9-12,주간
12:00 ~ 14:59,1517,1517,12471,7791,613939840,20262,20240427,12-15,주간
15:00 ~ 17:59,1624,1624,10549,9797,510307360,20346,20240427,15-18,주간
18:00 ~ 20:59,2268,2268,16526,13671,1018475300,30197,20240427,18-21,저녁
21:00 ~ 23:59,7,7,2,26,1681000,28,20240427,21-24,저녁
합계,6112,6112,41715,33924,2235641930,75639,20240427,,
00:00 ~ 2:59,0,0,0,0,0,0,20240428,0-3,심야
3:00 ~ 5:59,0,0,0,0,0,0,20240428,3-6,심야
6:00 ~ 8:59,0,0,0,0,0,0,20240428,6-9,심야
9:00 ~ 11:59,656,656,1529,2960,99377080,4489,20240428,9-12,주간
12:00 ~ 14:59,1415,1415,7322,8042,534037090,15364,20240428,12-15,주간
15:00 ~ 17:59,1527,1527,5392,8942,440948740,14334,20240428,15-18,주간
18:00 ~ 20:59,2128,2128,10645,10797,621540040,21442,20240428,18-21,저녁
21:00 ~ 23:59,6,6,5,23,1132000,28,20240428,21-24,저녁
합계,5732,5732,24893,30764,1697034950,55657,20240428,,
00:00 ~ 2:59,0,0,0,0,0,0,20240429,0-3,심야
3:00 ~ 5:59,0,0,0,0,0,0,20240429,3-6,심야
6:00 ~ 8:59,0,0,0,0,0,0,20240429,6-9,심야
9:00 ~ 11:59,712,712,1741,4556,131520890,6297,20240429,9-12,주간
12:00 ~ 14:59,1443,1443,7112,11106,683318484,18218,20240429,12-15,주간
15:00 ~ 17:59,1539,1539,5856,20564,1854907268,26420,20240429,15-18,주간
18:00 ~ 20:59,2319,2319,14699,32507,2615809725,47206,20240429,18-21,저녁
21:00 ~ 23:59,7,7,15,47,2852000,62,20240429,21-24,저녁
합계,6020,6020,29423,68780,5288408367,98203,20240429,,
00:00 ~ 2:59,0,0,0,0,0,0,20240430,0-3,심야
3:00 ~ 5:59,0,0,0,0,0,0,20240430,3-6,심야
6:00 ~ 8:59,0,0,0,0,0,0,20240430,6-9,심야
9:00 ~ 11:59,735,735,2193,7277,211608110,9470,20240430,9-12,주간
12:00 ~ 14:59,1491,1491,9018,20019,1247138990,29037,20240430,12-15,주간
15:00 ~ 17:59,1602,1602,6708,15874,962822400,22582,20240430,15-18,주간
18:00 ~ 20:59,2491,2491,18901,34131,2420925164,53032,20240430,18-21,저녁
21:00 ~ 23:59,10,10,37,305,5921000,342,20240430,21-24,저녁
합계,6329,6329,36857,77606,4848415664,114463,20240430,,
00:00 ~ 2:59,0,0,0,0,0,0,20240501,0-3,심야
3:00 ~ 5:59,0,0,0,0,0,0,20240501,3-6,심야
6:00 ~ 8:59,0,0,0,0,0,0,20240501,6-9,심야
9:00 ~ 11:59,714,714,1744,5819,147286100,7563,20240501,9-12,주간
12:00 ~ 14:59,1482,1482,7167,13392,785610470,20559,20240501,12-15,주간
15:00 ~ 17:59,1664,1664,5626,11002,468608580,16628,20240501,15-18,주간
18:00 ~ 20:59,2410,2410,14428,19303,1342893080,33731,20240501,18-21,저녁
21:00 ~ 23:59,16,16,47,135,3892650,182,20240501,21-24,저녁
합계,6286,6286,29012,49651,2748290880,78663,20240501,,
00:00 ~ 2:59,0,0,0,0,0,0,20240502,0-3,심야
3:00 ~ 5:59,0,0,0,0,0,0,20240502,3-6,심야
6:00 ~ 8:59,0,0,0,0,0,0,20240502,6-9,심야
9:00 ~ 11:59,729,729,3266,7521,272651740,10787,20240502,9-12,주간
12:00 ~ 14:59,1591,1591,19277,14892,835090890,34169,20240502,12-15,주간
15:00 ~ 17:59,1714,1714,16525,32363,2843683190,48888,20240502,15-18,주간
18:00 ~ 20:59,2567,2567,27471,44351,2023810201,71822,20240502,18-21,저녁
21:00 ~ 23:59,7,7,13,68,3184000,81,20240502,21-24,저녁
합계,6608,6608,66552,99195,5978420021,165747,20240502,,
00:00 ~ 2:59,0,0,0,0,0,0,20240503,0-3,심야
3:00 ~ 5:59,0,0,0,0,0,0,20240503,3-6,심야
6:00 ~ 8:59,0,0,0,0,0,0,20240503,6-9,심야
9:00 ~ 11:59,713,713,3354,12145,1186481360,15499,20240503,9-12,주간
12:00 ~ 14:59,1591,1591,10176,14940,751422370,25116,20240503,12-15,주간
15:00 ~ 17:59,1715,1715,12629,21894,1297827800,34523,20240503,15-18,주간
18:00 ~ 20:59,2494,2494,28768,44665,3868104100,73433,20240503,18-21,저녁
21:00 ~ 23:59,10,10,14,72,1108950,86,20240503,21-24,저녁
합계,6523,6523,54941,93716,7104944580,148657,20240503,,
00:00 ~ 2:59,0,0,0,0,0,0,20240504,0-3,심야
3:00 ~ 5:59,0,0,0,0,0,0,20240504,3-6,심야
6:00 ~ 8:59,0,0,0,0,0,0,20240504,6-9,심야
9:00 ~ 11:59,648,648,1942,5201,242774480,7143,20240504,9-12,주간
12:00 ~ 14:59,1543,1543,11249,10813,660956020,22062,20240504,12-15,주간
15:00 ~ 17:59,1626,1626,8114,12050,439551310,20164,20240504,15-18,주간
18:00 ~ 20:59,2257,2257,17505,14226,1546271302,31731,20240504,18-21,저녁
21:00 ~ 23:59,7,7,5,52,1123000,57,20240504,21-24,저녁
합계,6081,6081,38815,42342,2890676112,81157,20240504,,
00:00 ~ 2:59,0,0,0,0,0,0,20240505,0-3,심야
3:00 ~ 5:59,0,0,0,0,0,0,20240505,3-6,심야
6:00 ~ 8:59,0,0,0,0,0,0,20240505,6-9,심야
9:00 ~ 11:59,598,598,4135,2886,122434960,7021,20240505,9-12,주간
12:00 ~ 14:59,1375,1375,8824,12848,581292890,21672,20240505,12-15,주간
15:00 ~ 17:59,1498,1498,7820,9285,394783710,17105,20240505,15-18,주간
18:00 ~ 20:59,2103,2103,11343,11113,687104130,22456,20240505,18-21,저녁
21:00 ~ 23:59,9,9,4,53,305150,57,20240505,21-24,저녁
합계,5583,5583,32126,36185,1785920840,68311,20240505,,
00:00 ~ 2:59,0,0,0,0,0,0,20240506,0-3,심야
3:00 ~ 5:59,0,0,0,0,0,0,20240506,3-6,심야
6:00 ~ 8:59,0,0,0,0,0,0,20240506,6-9,심야
9:00 ~ 11:59,511,511,1306,2416,101683110,3722,20240506,9-12,주간
12:00 ~ 14:59,1241,1241,6579,7130,458179950,13709,20240506,12-15,주간
15:00 ~ 17:59,1371,1371,4716,6019,315264830,10735,20240506,15-18,주간
18:00 ~ 20:59,2147,2147,9538,9307,627587970,18845,20240506,18-21,저녁
21:00 ~ 23:59,6,6,6,12,227100,18,20240506,21-24,저녁
합계,5276,5276,22145,24884,1502942960,47029,20240506,,
00:00 ~ 2:59,0,0,0,0,0,0,20240507,0-3,심야
3:00 ~ 5:59,0,0,0,0,0,0,20240507,3-6,심야
6:00 ~ 8:59,0,0,0,0,0,0,20240507,6-9,심야
9:00 ~ 11:59,591,591,1861,4800,95067570,6661,20240507,9-12,주간
12:00 ~ 14:59,1213,1213,5832,12459,453959160,18291,20240507,12-15,주간
15:00 ~ 17:59,1450,1450,6062,10445,572193280,16507,20240507,15-18,주간
18:00 ~ 20:59,2386,2386,20485,25766,1207998952,46251,20240507,18-21,저녁
21:00 ~ 23:59,8,8,11,19,550900,30,20240507,21-24,저녁
합계,5648,5648,34251,53489,2329769862,87740,20240507,,
00:00 ~ 2:59,0,0,0,0,0,0,20240508,0-3,심야
3:00 ~ 5:59,0,0,0,0,0,0,20240508,3-6,심야
6:00 ~ 8:59,0,0,0,0,0,0,20240508,6-9,심야
9:00 ~ 11:59,601,601,1910,4250,112580520,6160,20240508,9-12,주간
12:00 ~ 14:59,1307,1307,5761,12337,651299970,18098,20240508,12-15,주간
15:00 ~ 17:59,1512,1512,6550,12178,623444170,18728,20240508,15-18,주간
18:00 ~ 20:59,2424,2424,16987,32977,1691741480,49964,20240508,18-21,저녁
21:00 ~ 23:59,10,10,64,145,3240000,209,20240508,21-24,저녁
합계,5854,5854,31272,61887,3082306140,93159,20240508,,
00:00 ~ 2:59,0,0,0,0,0,0,20240509,0-3,심야
3:00 ~ 5:59,0,0,0,0,0,0,20240509,3-6,심야
6:00 ~ 8:59,0,0,0,0,0,0,20240509,6-9,심야
9:00 ~ 11:59,606,606,2491,5368,120011450,7859,20240509,9-12,주간
12:00 ~ 14:59,1327,1327,8464,11491,674450980,19955,20240509,12-15,주간
15:00 ~ 17:59,1585,1585,9949,17294,1370004350,27243,20240509,15-18,주간
18:00 ~ 20:59,2439,2439,22483,28604,1895570630,51087,20240509,18-21,저녁
21:00 ~ 23:59,13,13,25,75,677300,100,20240509,21-24,저녁
합계,5970,5970,43412,62832,4060714710,106244,20240509,,
00:00 ~ 2:59,0,0,0,0,0,0,20240510,0-3,심야
3:00 ~ 5:59,0,0,0,0,0,0,20240510,3-6,심야
6:00 ~ 8:59,0,0,0,0,0,0,20240510,6-9,심야
9:00 ~ 11:59,609,609,2238,4791,109731540,7029,20240510,9-12,주간
12:00 ~ 14:59,1380,1380,7648,16900,685036660,24548,20240510,12-15,주간
15:00 ~ 17:59,1646,1646,8396,15603,603214992,23999,20240510,15-18,주간
18:00 ~ 20:59,2412,2412,20870,40950,1902918620,61820,20240510,18-21,저녁
21:00 ~ 23:59,9,9,8,52,1078600,60,20240510,21-24,저녁
합계,6056,6056,39160,78296,3301980412,117456,20240510,,
00:00 ~ 2:59,0,0,0,0,0,0,20240511,0-3,심야
3:00 ~ 5:59,0,0,0,0,0,0,20240511,3-6,심야
6:00 ~ 8:59,0,0,0,0,0,0,20240511,6-9,심야
9:00 ~ 11:59,578,578,1506,3033,113911950,4539,20240511,9-12,주간
12:00 ~ 14:59,1371,1371,8406,9045,546636400,17451,20240511,12-15,주간
15:00 ~ 17:59,1588,1588,6269,10323,477020090,16592,20240511,15-18,주간
18:00 ~ 20:59,2110,2110,11662,12633,753973300,24295,20240511,18-21,저녁
21:00 ~ 23:59,10,10,10,51,575700,61,20240511,21-24,저녁
합계,5657,5657,27853,35085,1892117440,62938,20240511,,
00:00 ~ 2:59,0,0,0,0,0,0,20240512,0-3,심야
3:00 ~ 5:59,0,0,0,0,0,0,20240512,3-6,심야
6:00 ~ 8:59,0,0,0,0,0,0,20240512,6-9,심야
9:00 ~ 11:59,526,526,993,2423,94288170,3416,20240512,9-12,주간
12:00 ~ 14:59,1257,1257,6844,6860,505630740,13704,20240512,12-15,주간
15:00 ~ 17:59,1476,1476,4967,7957,387728480,12924,20240512,15-18,주간
18:00 ~ 20:59,2041,2041,10678,8705,576896990,19383,20240512,18-21,저녁
21:00 ~ 23:59,9,9,11,30,348500,41,20240512,21-24,저녁
합계,5309,5309,23493,25975,1564892880,49468,20240512,,
00:00 ~ 2:59,0,0,0,0,0,0,20240513,0-3,심야
3:00 ~ 5:59,0,0,0,0,0,0,20240513,3-6,심야
6:00 ~ 8:59,0,0,0,0,0,0,20240513,6-9,심야
9:00 ~ 11:59,553,553,1419,5533,138666620,6952,20240513,9-12,주간
12:00 ~ 14:59,1227,1227,4257,11752,478457470,16009,20240513,12-15,주간
15:00 ~ 17:59,1481,1481,4922,10839,493615430,15761,20240513,15-18,주간
18:00 ~ 20:59,2319,2319,15137,26821,1009718770,41958,20240513,18-21,저녁
21:00 ~ 23:59,11,11,10,22,448850,32,20240513,21-24,저녁
합계,5591,5591,25745,54967,2120907140,80712,20240513,,
00:00 ~ 2:59,0,0,0,0,0,0,20240514,0-3,심야
3:00 ~ 5:59,0,0,0,0,0,0,20240514,3-6,심야
6:00 ~ 8:59,0,0,0,0,0,0,20240514,6-9,심야
9:00 ~ 11:59,601,601,1998,6321,163239070,8319,20240514,9-12,주간
12:00 ~ 14:59,1256,1256,9069,25067,881771060,34136,20240514,12-15,주간
15:00 ~ 17:59,1572,1572,7650,24113,1123738980,31763,20240514,15-18,주간
18:00 ~ 20:59,2380,2380,21922,52729,2579040620,74651,20240514,18-21,저녁
21:00 ~ 23:59,12,12,9,32,957300,41,20240514,21-24,저녁
합계,5821,5821,40648,108262,4748747030,148910,20240514,,
00:00 ~ 2:59,0,0,0,0,0,0,20240515,0-3,심야
3:00 ~ 5:59,0,0,0,0,0,0,20240515,3-6,심야
6:00 ~ 8:59,0,0,0,0,0,0,20240515,6-9,심야
9:00 ~ 11:59,535,535,1098,2412,87259430,3510,20240515,9-12,주간
12:00 ~ 14:59,1212,1212,6446,7871,494047557,14317,20240515,12-15,주간
15:00 ~ 17:59,1465,1465,5650,7960,416946160,13610,20240515,15-18,주간
18:00 ~ 20:59,2232,2232,12123,14878,944942140,27001,20240515,18-21,저녁
21:00 ~ 23:59,10,10,2,31,629100,33,20240515,21-24,저녁
합계,5454,5454,25319,33152,1943824387,58471,20240515,,
00:00 ~ 2:59,0,0,0,0,0,0,20240516,0-3,심야
3:00 ~ 5:59,0,0,0,0,0,0,20240516,3-6,심야
6:00 ~ 8:59,0,0,0,0,0,0,20240516,6-9,심야
9:00 ~ 11:59,623,623,2565,15591,1796313720,18156,20240516,9-12,주간
12:00 ~ 14:59,1277,1277,9003,16623,909156278,25626,20240516,12-15,주간
15:00 ~ 17:59,1565,1565,10035,16905,1104190120,26940,20240516,15-18,주간
18:00 ~ 20:59,2437,2437,22423,41634,2597818520,64057,20240516,18-21,저녁
21:00 ~ 23:59,11,11,13,48,716200,61,20240516,21-24,저녁
합계,5913,5913,44039,90801,6408194838,134840,20240516,,
00:00 ~ 2:59,0,0,0,0,0,0,20240517,0-3,심야
3:00 ~ 5:59,0,0,0,0,0,0,20240517,3-6,심야
6:00 ~ 8:59,0,0,0,0,0,0,20240517,6-9,심야
9:00 ~ 11:59,595,595,4298,16634,1930424620,20932,20240517,9-12,주간
12:00 ~ 14:59,1296,1296,10906,25625,950307320,36531,20240517,12-15,주간
15:00 ~ 17:59,1632,1632,7467,19534,719688300,27001,20240517,15-18,주간
18:00 ~ 20:59,2418,2418,21621,42722,2627123370,64343,20240517,18-21,저녁
21:00 ~ 23:59,12,12,8,81,1614550,89,20240517,21-24,저녁
합계,5953,5953,44300,104596,6229158160,148896,20240517,,
00:00 ~ 2:59,0,0,0,0,0,0,20240518,0-3,심야
3:00 ~ 5:59,0,0,0,0,0,0,20240518,3-6,심야
6:00 ~ 8:59,0,0,0,0,0,0,20240518,6-9,심야
9:00 ~ 11:59,562,562,2964,4612,337567820,7576,20240518,9-12,주간
12:00 ~ 14:59,1236,1236,8615,9332,499331270,17947,20240518,12-15,주간
15:00 ~ 17:59,1512,1512,7790,8576,402032680,16366,20240518,15-18,주간
18:00 ~ 20:59,2036,2036,13557,14907,816372440,28464,20240518,18-21,저녁
21:00 ~ 23:59,13,13,5,66,1873750,71,20240518,21-24,저녁
합계,5359,5359,32931,37493,2057177960,70424,20240518,,
00:00 ~ 2:59,0,0,0,0,0,0,20240519,0-3,심야
3:00 ~ 5:59,0,0,0,0,0,0,20240519,3-6,심야
6:00 ~ 8:59,0,0,0,0,0,0,20240519,6-9,심야
9:00 ~ 11:59,503,503,2268,2148,89925970,4416,20240519,9-12,주간
12:00 ~ 14:59,1123,1123,6589,5576,408762990,12165,20240519,12-15,주간
15:00 ~ 17:59,1345,1345,4485,6887,335355670,11372,20240519,15-18,주간
18:00 ~ 20:59,1995,1995,10247,12426,662264730,22673,20240519,18-21,저녁
21:00 ~ 23:59,12,12,18,60,376900,78,20240519,21-24,저녁
합계,4978,4978,23607,27097,1496686260,50704,20240519,,
00:00 ~ 2:59,0,0,0,0,0,0,20240520,0-3,심야
3:00 ~ 5:59,0,0,0,0,0,0,20240520,3-6,심야
6:00 ~ 8:59,0,0,0,0,0,0,20240520,6-9,심야
9:00 ~ 11:59,588,588,2209,3220,81877820,5429,20240520,9-12,주간
12:00 ~ 14:59,1153,1153,7130,10504,398065470,17634,20240520,12-15,주간
15:00 ~ 17:59,1423,1423,5624,9197,442548210,14821,20240520,15-18,주간
18:00 ~ 20:59,2241,2241,15836,26230,1177825410,42066,20240520,18-21,저녁
21:00 ~ 23:59,8,8,2,14,434000,16,20240520,21-24,저녁
합계,5413,5413,30801,49165,2100750910,79966,20240520,,
00:00 ~ 2:59,0,0,0,0,0,0,20240521,0-3,심야
3:00 ~ 5:59,0,0,0,0,0,0,20240521,3-6,심야
6:00 ~ 8:59,0,0,0,0,0,0,20240521,6-9,심야
9:00 ~ 11:59,550,550,2844,3997,128518850,6841,20240521,9-12,주간
12:00 ~ 14:59,1198,1198,6133,13865,1017171390,19998,20240521,12-15,주간
15:00 ~ 17:59,1548,1548,5905,12559,549164060,18464,20240521,15-18,주간
18:00 ~ 20:59,2426,2426,17184,32261,1758798990,49445,20240521,18-21,저녁
21:00 ~ 23:59,11,11,12,26,913750,38,20240521,21-24,저녁
합계,5733,5733,32078,62708,3454567040,94786,20240521,,
00:00 ~ 2:59,0,0,0,0,0,0,20240522,0-3,심야
3:00 ~ 5:59,0,0,0,0,0,0,20240522,3-6,심야
6:00 ~ 8:59,0,0,0,0,0,0,20240522,6-9,심야
9:00 ~ 11:59,644,644,3775,16494,132395560,20269,20240522,9-12,주간
12:00 ~ 14:59,1248,1248,6148,21688,650060320,27836,20240522,12-15,주간
15:00 ~ 17:59,1558,1558,5704,18524,440569880,24228,20240522,15-18,주간
18:00 ~ 20:59,2381,2381,20287,24231,1533397510,44518,20240522,18-21,저녁
21:00 ~ 23:59,12,12,0,42,664900,42,20240522,21-24,저녁
합계,5843,5843,35914,80979,2757088170,116893,20240522,,
00:00 ~ 2:59,0,0,0,0,0,0,20240523,0-3,심야
3:00 ~ 5:59,0,0,0,0,0,0,20240523,3-6,심야
6:00 ~ 8:59,0,0,0,0,0,0,20240523,6-9,심야
9:00 ~ 11:59,633,633,3086,4566,81897960,7652,20240523,9-12,주간
12:00 ~ 14:59,1262,1262,5831,10682,584713290,16513,20240523,12-15,주간
15:00 ~ 17:59,1584,1584,9537,17040,1300159910,26577,20240523,15-18,주간
18:00 ~ 20:59,2353,2353,17593,34164,1503660069,51757,20240523,18-21,저녁
21:00 ~ 23:59,8,8,9,44,426500,53,20240523,21-24,저녁
합계,5840,5840,36056,66496,3470857729,102552,20240523,,
00:00 ~ 2:59,0,0,0,0,0,0,20240524,0-3,심야
3:00 ~ 5:59,0,0,0,0,0,0,20240524,3-6,심야
6:00 ~ 8:59,0,0,0,0,0,0,20240524,6-9,심야
9:00 ~ 11:59,642,642,3602,4089,107774030,7691,20240524,9-12,주간
12:00 ~ 14:59,1332,1332,6844,11485,648540520,18329,20240524,12-15,주간
15:00 ~ 17:59,1580,1580,8167,18036,958144425,26203,20240524,15-18,주간
18:00 ~ 20:59,2393,2393,18528,30037,1557857550,48565,20240524,18-21,저녁
21:00 ~ 23:59,10,10,4,30,570350,34,20240524,21-24,저녁
합계,5957,5957,37145,63677,3272886875,100822,20240524,,
00:00 ~ 2:59,0,0,0,0,0,0,20240525,0-3,심야
3:00 ~ 5:59,0,0,0,0,0,0,20240525,3-6,심야
6:00 ~ 8:59,0,0,0,0,0,0,20240525,6-9,심야
9:00 ~ 11:59,562,562,1946,3499,117249700,5445,20240525,9-12,주간
12:00 ~ 14:59,1249,1249,9301,6676,535110110,15977,20240525,12-15,주간
15:00 ~ 17:59,1511,1511,6932,10567,452219220,17499,20240525,15-18,주간
18:00 ~ 20:59,2053,2053,13200,10830,793970130,24030,20240525,18-21,저녁
21:00 ~ 23:59,5,5,3,44,132500,47,20240525,21-24,저녁
합계,5380,5380,31382,31616,1898681660,62998,20240525,,
00:00 ~ 2:59,0,0,0,0,0,0,20240526,0-3,심야
3:00 ~ 5:59,0,0,0,0,0,0,20240526,3-6,심야
6:00 ~ 8:59,0,0,0,0,0,0,20240526,6-9,심야
9:00 ~ 11:59,532,532,1592,2500,103968770,4092,20240526,9-12,주간
12:00 ~ 14:59,1215,1215,7910,6013,363881822,13923,20240526,12-15,주간
15:00 ~ 17:59,1383,1383,4625,8325,382572980,12950,20240526,15-18,주간
18:00 ~ 20:59,2010,2010,9412,9300,586417400,18712,20240526,18-21,저녁
21:00 ~ 23:59,4,4,2,13,47900,15,20240526,21-24,저녁
합계,5144,5144,23541,26151,1436888872,49692,20240526,,
00:00 ~ 2:59,0,0,0,0,0,0,20240527,0-3,심야
3:00 ~ 5:59,0,0,0,0,0,0,20240527,3-6,심야
6:00 ~ 8:59,0,0,0,0,0,0,20240527,6-9,심야
9:00 ~ 11:59,550,550,2038,3596,113882360,5634,20240527,9-12,주간
12:00 ~ 14:59,1177,1177,5166,6469,360760505,11635,20240527,12-15,주간
15:00 ~ 17:59,1421,1421,5188,8013,319185900,13201,20240527,15-18,주간
18:00 ~ 20:59,2207,2207,14289,15994,743866020,30283,20240527,18-21,저녁
21:00 ~ 23:59,8,8,0,19,408000,19,20240527,21-24,저녁
합계,5363,5363,26681,34091,1538102785,60772,20240527,,
00:00 ~ 2:59,0,0,0,0,0,0,20240528,0-3,심야
3:00 ~ 5:59,0,0,0,0,0,0,20240528,3-6,심야
6:00 ~ 8:59,0,0,0,0,0,0,20240528,6-9,심야
9:00 ~ 11:59,633,633,2653,3887,122110910,6540,20240528,9-12,주간
12:00 ~ 14:59,1249,1249,6187,12914,599023000,19101,20240528,12-15,주간
15:00 ~ 17:59,1525,1525,5895,12016,377879520,17911,20240528,15-18,주간
18:00 ~ 20:59,2344,2344,18383,37387,1843591652,55770,20240528,18-21,저녁
21:00 ~ 23:59,8,8,7,28,132100,35,20240528,21-24,저녁
합계,5759,5759,33125,66232,2942737182,99357,20240528,,
00:00 ~ 2:59,0,0,0,0,0,0,20240529,0-3,심야
3:00 ~ 5:59,0,0,0,0,0,0,20240529,3-6,심야
6:00 ~ 8:59,0,0,0,0,0,0,20240529,6-9,심야
9:00 ~ 11:59,649,649,2800,5796,213970710,8596,20240529,9-12,주간
12:00 ~ 14:59,1260,1260,5726,14109,919899660,19835,20240529,12-15,주간
15:00 ~ 17:59,1473,1473,7698,11171,414210270,18869,20240529,15-18,주간
18:00 ~ 20:59,2354,2354,16933,33157,1487048411,50090,20240529,18-21,저녁
21:00 ~ 23:59,10,10,8,58,739900,66,20240529,21-24,저녁
합계,5746,5746,33165,64291,3035868951,97456,20240529,,
00:00 ~ 2:59,0,0,0,0,0,0,20240530,0-3,심야
3:00 ~ 5:59,0,0,0,0,0,0,20240530,3-6,심야
6:00 ~ 8:59,0,0,0,0,0,0,20240530,6-9,심야
9:00 ~ 11:59,624,624,2207,3689,104143540,5896,20240530,9-12,주간
12:00 ~ 14:59,1259,1259,8738,14824,1481270330,23562,20240530,12-15,주간
15:00 ~ 17:59,1518,1518,5019,9563,336362750,14582,20240530,15-18,주간
18:00 ~ 20:59,2379,2379,18485,31481,1814872418,49966,20240530,18-21,저녁
21:00 ~ 23:59,8,8,8,57,530200,65,20240530,21-24,저녁
합계,5788,5788,34457,59614,3737179238,94071,20240530,,
00:00 ~ 2:59,0,0,0,0,0,0,20240531,0-3,심야
3:00 ~ 5:59,0,0,0,0,0,0,20240531,3-6,심야
6:00 ~ 8:59,0,0,0,0,0,0,20240531,6-9,심야
9:00 ~ 11:59,652,652,2255,4735,144475470,6990,20240531,9-12,주간
12:00 ~ 14:59,1332,1332,5982,15271,840939170,21253,20240531,12-15,주간
15:00 ~ 17:59,1550,1550,5611,12377,405651952,17988,20240531,15-18,주간
18:00 ~ 20:59,2310,2310,15087,29507,1600721153,44594,20240531,18-21,저녁
21:00 ~ 23:59,7,7,8,39,308200,47,20240531,21-24,저녁
합계,5851,5851,28943,61929,2992095945,90872,20240531,,
00:00 ~ 2:59,0,0,0,0,0,0,20240601,0-3,심야
3:00 ~ 5:59,0,0,0,0,0,0,20240601,3-6,심야
6:00 ~ 8:59,0,0,0,0,0,0,20240601,6-9,심야
9:00 ~ 11:59,666,666,1545,3759,172637280,5304,20240601,9-12,주간
12:00 ~ 14:59,1357,1357,7251,9936,691638430,17187,20240601,12-15,주간
15:00 ~ 17:59,1603,1603,5876,9700,422175850,15576,20240601,15-18,주간
18:00 ~ 20:59,2159,2159,13072,13151,864588340,26223,20240601,18-21,저녁
21:00 ~ 23:59,8,8,4,52,806400,56,20240601,21-24,저녁
합계,5793,5793,27748,36598,2151846300,64346,20240601,,
00:00 ~ 2:59,0,0,0,0,0,0,20240602,0-3,심야
3:00 ~ 5:59,0,0,0,0,0,0,20240602,3-6,심야
6:00 ~ 8:59,0,0,0,0,0,0,20240602,6-9,심야
9:00 ~ 11:59,626,626,1707,2791,134022870,4498,20240602,9-12,주간
12:00 ~ 14:59,1243,1243,6997,8019,478271950,15016,20240602,12-15,주간
15:00 ~ 17:59,1454,1454,4371,8215,340405400,12586,20240602,15-18,주간
18:00 ~ 20:59,2036,2036,9730,11548,713744120,21278,20240602,18-21,저녁
21:00 ~ 23:59,7,7,1,20,325000,21,20240602,21-24,저녁
합계,5366,5366,22806,30593,1666769340,53399,20240602,,
00:00 ~ 2:59,0,0,0,0,0,0,20240603,0-3,심야
3:00 ~ 5:59,0,0,0,0,0,0,20240603,3-6,심야
6:00 ~ 8:59,0,0,0,0,0,0,20240603,6-9,심야
9:00 ~ 11:59,622,622,1718,3139,97066400,4857,20240603,9-12,주간
12:00 ~ 14:59,1249,1249,6040,9517,558384810,15557,20240603,12-15,주간
15:00 ~ 17:59,1503,1503,4389,17980,1846148600,22369,20240603,15-18,주간
18:00 ~ 20:59,2280,2280,15998,34533,2470596980,50531,20240603,18-21,저녁
21:00 ~ 23:59,8,8,2,11,216000,13,20240603,21-24,저녁
합계,5662,5662,28147,65180,4972412790,93327,20240603,,
00:00 ~ 2:59,0,0,0,0,0,0,20240604,0-3,심야
3:00 ~ 5:59,0,0,0,0,0,0,20240604,3-6,심야
6:00 ~ 8:59,0,0,0,0,0,0,20240604,6-9,심야
9:00 ~ 11:59,648,648,2009,6436,123732590,8445,20240604,9-12,주간
12:00 ~ 14:59,1275,1275,6359,9647,459459060,16006,20240604,12-15,주간
15:00 ~ 17:59,1529,1529,5538,17241,1186967710,22779,20240604,15-18,주간
18:00 ~ 20:59,2351,2351,17745,35343,1505330023,53088,20240604,18-21,저녁
21:00 ~ 23:59,9,9,6,39,999200,45,20240604,21-24,저녁
합계,5812,5812,31657,68706,3276488583,100363,20240604,,
00:00 ~ 2:59,0,0,0,0,0,0,20240605,0-3,심야
3:00 ~ 5:59,0,0,0,0,0,0,20240605,3-6,심야
6:00 ~ 8:59,0,0,0,0,0,0,20240605,6-9,심야
9:00 ~ 11:59,657,657,3330,6696,64162090,10026,20240605,9-12,주간
12:00 ~ 14:59,1294,1294,6288,14625,819927700,20913,20240605,12-15,주간
15:00 ~ 17:59,1562,1562,6470,14990,1049860290,21460,20240605,15-18,주간
18:00 ~ 20:59,2425,2425,15768,29658,2042684203,45426,20240605,18-21,저녁
21:00 ~ 23:59,15,15,0,127,262300,127,20240605,21-24,저녁
합계,5953,5953,31856,66096,3976896583,97952,20240605,,
00:00 ~ 2:59,0,0,0,0,0,0,20240606,0-3,심야
3:00 ~ 5:59,0,0,0,0,0,0,20240606,3-6,심야
6:00 ~ 8:59,0,0,0,0,0,0,20240606,6-9,심야
9:00 ~ 11:59,606,606,1896,4072,79113220,5968,20240606,9-12,주간
12:00 ~ 14:59,1326,1326,6331,8784,478057380,15115,20240606,12-15,주간
15:00 ~ 17:59,1485,1485,5346,8890,480478500,14236,20240606,15-18,주간
18:00 ~ 20:59,2156,2156,9187,13320,924298611,22507,20240606,18-21,저녁
21:00 ~ 23:59,8,8,6,30,416000,36,20240606,21-24,저녁
합계,5581,5581,22766,35096,1962363711,57862,20240606,,
00:00 ~ 2:59,0,0,0,0,0,0,20240607,0-3,심야
3:00 ~ 5:59,0,0,0,0,0,0,20240607,3-6,심야
6:00 ~ 8:59,0,0,0,0,0,0,20240607,6-9,심야
9:00 ~ 11:59,605,605,5179,15221,1425153430,20400,20240607,9-12,주간
12:00 ~ 14:59,1280,1280,6564,12455,501145120,19019,20240607,12-15,주간
15:00 ~ 17:59,1516,1516,6016,16929,711945690,22945,20240607,15-18,주간
18:00 ~ 20:59,2348,2348,14021,29560,1132088354,43581,20240607,18-21,저녁
21:00 ~ 23:59,19,19,40,200,8774500,240,20240607,21-24,저녁
합계,5768,5768,31820,74365,3779107094,106185,20240607,,
00:00 ~ 2:59,0,0,0,0,0,0,20240608,0-3,심야
3:00 ~ 5:59,0,0,0,0,0,0,20240608,3-6,심야
6:00 ~ 8:59,0,0,0,0,0,0,20240608,6-9,심야
9:00 ~ 11:59,570,570,1911,4573,199420050,6484,20240608,9-12,주간
12:00 ~ 14:59,1187,1187,6675,8018,511555450,14693,20240608,12-15,주간
15:00 ~ 17:59,1431,1431,5573,9246,404499898,14819,20240608,15-18,주간
18:00 ~ 20:59,2030,2030,9019,11007,664692600,20026,20240608,18-21,저녁
21:00 ~ 23:59,11,11,11,37,1382600,48,20240608,21-24,저녁
합계,5229,5229,23189,32881,1781550598,56070,20240608,,
00:00 ~ 2:59,0,0,0,0,0,0,20240609,0-3,심야
3:00 ~ 5:59,0,0,0,0,0,0,20240609,3-6,심야
6:00 ~ 8:59,0,0,0,0,0,0,20240609,6-9,심야
9:00 ~ 11:59,552,552,1785,3865,181686960,5650,20240609,9-12,주간
12:00 ~ 14:59,1120,1120,5576,6302,422452630,11878,20240609,12-15,주간
15:00 ~ 17:59,1321,1321,4728,7421,334460860,12149,20240609,15-18,주간
18:00 ~ 20:59,1961,1961,8466,9117,560165940,17583,20240609,18-21,저녁
21:00 ~ 23:59,12,12,20,31,1243600,51,20240609,21-24,저녁
합계,4966,4966,20575,26736,1500009990,47311,20240609,,
00:00 ~ 2:59,0,0,0,0,0,0,20240610,0-3,심야
3:00 ~ 5:59,0,0,0,0,0,0,20240610,3-6,심야
6:00 ~ 8:59,0,0,0,0,0,0,20240610,6-9,심야
9:00 ~ 11:59,586,586,2694,4129,124112770,6823,20240610,9-12,주간
12:00 ~ 14:59,1157,1157,6024,12277,718448090,18301,20240610,12-15,주간
15:00 ~ 17:59,1401,1401,5751,11703,661666470,17454,20240610,15-18,주간
18:00 ~ 20:59,2333,2333,57910,358043,57192316200,415953,20240610,18-21,저녁
21:00 ~ 23:59,13,13,16,38,1347000,54,20240610,21-24,저녁
합계,5490,5490,72395,386190,58697890530,458585,20240610,,
00:00 ~ 2:59,0,0,0,0,0,0,20240611,0-3,심야
3:00 ~ 5:59,0,0,0,0,0,0,20240611,3-6,심야
6:00 ~ 8:59,0,0,0,0,0,0,20240611,6-9,심야
9:00 ~ 11:59,632,632,2221,4173,141046600,6394,20240611,9-12,주간
12:00 ~ 14:59,1169,1169,7978,11961,1187336855,19939,20240611,12-15,주간
15:00 ~ 17:59,1471,1471,5252,14227,620249201,19479,20240611,15-18,주간
18:00 ~ 20:59,2430,2430,47093,71820,7084241970,118913,20240611,18-21,저녁
21:00 ~ 23:59,18,18,17,55,1084500,72,20240611,21-24,저녁
합계,5720,5720,62561,102236,9033959126,164797,20240611,,
00:00 ~ 2:59,0,0,0,0,0,0,20240612,0-3,심야
3:00 ~ 5:59,0,0,0,0,0,0,20240612,3-6,심야
6:00 ~ 8:59,0,0,0,0,0,0,20240612,6-9,심야
9:00 ~ 11:59,662,662,3218,6348,146429790,9566,20240612,9-12,주간
12:00 ~ 14:59,1243,1243,7298,13627,1013359630,20925,20240612,12-15,주간
15:00 ~ 17:59,1567,1567,6173,14028,716110440,20201,20240612,15-18,주간
18:00 ~ 20:59,2494,2494,43048,52202,5064825424,95250,20240612,18-21,저녁
21:00 ~ 23:59,21,21,4,93,1440250,97,20240612,21-24,저녁
합계,5987,5987,59741,86298,6942165534,146039,20240612,,
00:00 ~ 2:59,0,0,0,0,0,0,20240613,0-3,심야
3:00 ~ 5:59,0,0,0,0,0,0,20240613,3-6,심야
6:00 ~ 8:59,0,0,0,0,0,0,20240613,6-9,심야
9:00 ~ 11:59,667,667,2462,7461,157859140,9923,20240613,9-12,주간
12:00 ~ 14:59,1276,1276,7387,11122,559317580,18509,20240613,12-15,주간
15:00 ~ 17:59,1558,1558,7324,15914,787152280,23238,20240613,15-18,주간
18:00 ~ 20:59,2472,2472,37880,52489,2851831839,90369,20240613,18-21,저녁
21:00 ~ 23:59,16,16,10,54,1102500,64,20240613,21-24,저녁
합계,5989,5989,55063,87040,4357263339,142103,20240613,,
00:00 ~ 2:59,0,0,0,0,0,0,20240614,0-3,심야
3:00 ~ 5:59,0,0,0,0,0,0,20240614,3-6,심야
6:00 ~ 8:59,0,0,0,0,0,0,20240614,6-9,심야
9:00 ~ 11:59,648,648,3769,5449,142134370,9218,20240614,9-12,주간
12:00 ~ 14:59,1343,1343,8199,13645,621966620,21844,20240614,12-15,주간
15:00 ~ 17:59,1593,1593,6460,14804,631595200,21264,20240614,15-18,주간
18:00 ~ 20:59,2442,2442,28507,64404,1836400064,92911,20240614,18-21,저녁
21:00 ~ 23:59,15,15,23,75,522100,98,20240614,21-24,저녁
합계,6041,6041,46958,98377,3232618354,145335,20240614,,
00:00 ~ 2:59,0,0,0,0,0,0,20240615,0-3,심야
3:00 ~ 5:59,0,0,0,0,0,0,20240615,3-6,심야
6:00 ~ 8:59,0,0,0,0,0,0,20240615,6-9,심야
9:00 ~ 11:59,622,622,1262,3633,119557440,4895,20240615,9-12,주간
12:00 ~ 14:59,1254,1254,6646,8890,507849790,15536,20240615,12-15,주간
15:00 ~ 17:59,1534,1534,5073,11915,474181150,16988,20240615,15-18,주간
18:00 ~ 20:59,2154,2154,17048,14657,1029087472,31705,20240615,18-21,저녁
21:00 ~ 23:59,13,13,8,39,548750,47,20240615,21-24,저녁
합계,5577,5577,30037,39134,2131224602,69171,20240615,,
00:00 ~ 2:59,0,0,0,0,0,0,20240616,0-3,심야
3:00 ~ 5:59,0,0,0,0,0,0,20240616,3-6,심야
6:00 ~ 8:59,0,0,0,0,0,0,20240616,6-9,심야
9:00 ~ 11:59,587,587,1081,8428,120092150,9509,20240616,9-12,주간
12:00 ~ 14:59,1188,1188,5416,7202,394724870,12618,20240616,12-15,주간
15:00 ~ 17:59,1398,1398,4548,7534,328096995,12082,20240616,15-18,주간
18:00 ~ 20:59,2054,2054,19151,9774,430733010,28925,20240616,18-21,저녁
21:00 ~ 23:59,13,13,15,42,676700,57,20240616,21-24,저녁
합계,5240,5240,30211,32980,1274323725,63191,20240616,,
00:00 ~ 2:59,0,0,0,0,0,0,20240617,0-3,심야
3:00 ~ 5:59,0,0,0,0,0,0,20240617,3-6,심야
6:00 ~ 8:59,0,0,0,0,0,0,20240617,6-9,심야
9:00 ~ 11:59,622,622,6947,-1591,90938530,5356,20240617,9-12,주간
12:00 ~ 14:59,1170,1170,6161,12068,561580880,18229,20240617,12-15,주간
15:00 ~ 17:59,1483,1483,5145,12236,593182580,17381,20240617,15-18,주간
18:00 ~ 20:59,2394,2394,31513,38796,641681741,70309,20240617,18-21,저녁
21:00 ~ 23:59,12,12,16,20,61600,36,20240617,21-24,저녁
합계,5681,5681,49782,61529,1887445331,111311,20240617,,
00:00 ~ 2:59,0,0,0,0,0,0,20240618,0-3,심야
3:00 ~ 5:59,0,0,0,0,0,0,20240618,3-6,심야
6:00 ~ 8:59,0,0,0,0,0,0,20240618,6-9,심야
9:00 ~ 11:59,659,659,2329,6776,289948600,9105,20240618,9-12,주간
12:00 ~ 14:59,1205,1205,7490,13891,814406320,21381,20240618,12-15,주간
15:00 ~ 17:59,1491,1491,8421,21702,2108247747,30123,20240618,15-18,주간
18:00 ~ 20:59,2519,2519,31548,68065,2997100412,99613,20240618,18-21,저녁
21:00 ~ 23:59,18,18,17,147,1305900,164,20240618,21-24,저녁
합계,5892,5892,49805,110581,6211008979,160386,20240618,,
00:00 ~ 2:59,0,0,0,0,0,0,20240619,0-3,심야
3:00 ~ 5:59,0,0,0,0,0,0,20240619,3-6,심야
6:00 ~ 8:59,0,0,0,0,0,0,20240619,6-9,심야
9:00 ~ 11:59,673,673,2194,5507,133183430,7701,20240619,9-12,주간
12:00 ~ 14:59,1267,1267,5965,8792,468882870,14757,20240619,12-15,주간
15:00 ~ 17:59,1570,1570,6795,14524,1079240680,21319,20240619,15-18,주간
18:00 ~ 20:59,2541,2541,22831,25573,1711277120,48404,20240619,18-21,저녁
21:00 ~ 23:59,15,15,17,29,791000,46,20240619,21-24,저녁
합계,6066,6066,37802,54425,3393375100,92227,20240619,,
00:00 ~ 2:59,0,0,0,0,0,0,20240620,0-3,심야
3:00 ~ 5:59,0,0,0,0,0,0,20240620,3-6,심야
6:00 ~ 8:59,0,0,0,0,0,0,20240620,6-9,심야
9:00 ~ 11:59,664,664,2695,4390,106742220,7085,20240620,9-12,주간
12:00 ~ 14:59,1285,1285,12254,13236,1088386860,25490,20240620,12-15,주간
15:00 ~ 17:59,1659,1659,6793,16705,680820928,23498,20240620,15-18,주간
18:00 ~ 20:59,2544,2544,30420,39134,3213087939,69554,20240620,18-21,저녁
21:00 ~ 23:59,15,15,22,30,498800,52,20240620,21-24,저녁
합계,6167,6167,52184,73495,5089536747,125679,20240620,,
00:00 ~ 2:59,0,0,0,0,0,0,20240621,0-3,심야
3:00 ~ 5:59,0,0,0,0,0,0,20240621,3-6,심야
6:00 ~ 8:59,0,0,0,0,0,0,20240621,6-9,심야
9:00 ~ 11:59,671,671,2000,3837,93269120,5837,20240621,9-12,주간
12:00 ~ 14:59,1394,1394,8301,16483,1035445972,24784,20240621,12-15,주간
15:00 ~ 17:59,1644,1644,8234,20776,701701622,29010,20240621,15-18,주간
18:00 ~ 20:59,2505,2505,26831,36274,1838687070,63105,20240621,18-21,저녁
21:00 ~ 23:59,14,14,23,45,218650,68,20240621,21-24,저녁
합계,6228,6228,45389,77415,3669322434,122804,20240621,,
00:00 ~ 2:59,0,0,0,0,0,0,20240622,0-3,심야
3:00 ~ 5:59,0,0,0,0,0,0,20240622,3-6,심야
6:00 ~ 8:59,0,0,0,0,0,0,20240622,6-9,심야
9:00 ~ 11:59,681,681,1454,3724,95789350,5178,20240622,9-12,주간
12:00 ~ 14:59,1371,1371,7843,8154,532975095,15997,20240622,12-15,주간
15:00 ~ 17:59,1633,1633,6710,12557,466265334,19267,20240622,15-18,주간
18:00 ~ 20:59,2255,2255,14234,16145,1019410850,30379,20240622,18-21,저녁
21:00 ~ 23:59,14,14,16,34,428500,50,20240622,21-24,저녁
합계,5954,5954,30257,40614,2114869129,70871,20240622,,
00:00 ~ 2:59,0,0,0,0,0,0,20240623,0-3,심야
3:00 ~ 5:59,0,0,0,0,0,0,20240623,3-6,심야
6:00 ~ 8:59,0,0,0,0,0,0,20240623,6-9,심야
9:00 ~ 11:59,626,626,1162,2932,97356590,4094,20240623,9-12,주간
12:00 ~ 14:59,1268,1268,8173,5408,314215440,13581,20240623,12-15,주간
15:00 ~ 17:59,1468,1468,4396,10082,421836520,14478,20240623,15-18,주간
18:00 ~ 20:59,2109,2109,14150,7846,689441120,21996,20240623,18-21,저녁
21:00 ~ 23:59,10,10,10,24,218400,34,20240623,21-24,저녁
합계,5481,5481,27891,26292,1523068070,54183,20240623,,
00:00 ~ 2:59,0,0,0,0,0,0,20240624,0-3,심야
3:00 ~ 5:59,0,0,0,0,0,0,20240624,3-6,심야
6:00 ~ 8:59,0,0,0,0,0,0,20240624,6-9,심야
9:00 ~ 11:59,630,630,1632,3623,130072750,5255,20240624,9-12,주간
12:00 ~ 14:59,1196,1196,7207,6688,317440220,13895,20240624,12-15,주간
15:00 ~ 17:59,1524,1524,5067,12193,505145470,17260,20240624,15-18,주간
18:00 ~ 20:59,2421,2421,21912,21534,1065622150,43446,20240624,18-21,저녁
21:00 ~ 23:59,18,18,29,43,215050,72,20240624,21-24,저녁
합계,5789,5789,35847,44081,2018495640,79928,20240624,,
00:00 ~ 2:59,0,0,0,0,0,0,20240625,0-3,심야
3:00 ~ 5:59,0,0,0,0,0,0,20240625,3-6,심야
6:00 ~ 8:59,0,0,0,0,0,0,20240625,6-9,심야
9:00 ~ 11:59,692,692,2103,4461,112155070,6564,20240625,9-12,주간
12:00 ~ 14:59,1232,1232,4959,9088,438744092,14047,20240625,12-15,주간
15:00 ~ 17:59,1600,1600,6878,13420,838977267,20298,20240625,15-18,주간
18:00 ~ 20:59,2663,2663,22396,30986,1588943532,53382,20240625,18-21,저녁
21:00 ~ 23:59,16,16,18,28,359050,46,20240625,21-24,저녁
합계,6203,6203,36354,57983,2979179011,94337,20240625,,
00:00 ~ 2:59,0,0,0,0,0,0,20240626,0-3,심야
3:00 ~ 5:59,0,0,0,0,0,0,20240626,3-6,심야
6:00 ~ 8:59,0,0,0,0,0,0,20240626,6-9,심야
9:00 ~ 11:59,710,710,2684,4021,90545610,6705,20240626,9-12,주간
12:00 ~ 14:59,1347,1347,7314,17493,1403431795,24807,20240626,12-15,주간
15:00 ~ 17:59,1649,1649,6896,14783,783119710,21679,20240626,15-18,주간
18:00 ~ 20:59,2720,2720,22207,42710,2919727390,64917,20240626,18-21,저녁
21:00 ~ 23:59,18,18,28,49,631500,77,20240626,21-24,저녁
합계,6444,6444,39129,79056,5197456005,118185,20240626,,
00:00 ~ 2:59,0,0,0,0,0,0,20240627,0-3,심야
3:00 ~ 5:59,0,0,0,0,0,0,20240627,3-6,심야
6:00 ~ 8:59,0,0,0,0,0,0,20240627,6-9,심야
9:00 ~ 11:59,691,691,6149,1836,98156640,7985,20240627,9-12,주간
12:00 ~ 14:59,1382,1382,10329,16558,1501187680,26887,20240627,12-15,주간
15:00 ~ 17:59,1629,1629,6362,20996,1616488490,27358,20240627,15-18,주간
18:00 ~ 20:59,2629,2629,31727,50286,4452031990,82013,20240627,18-21,저녁
21:00 ~ 23:59,12,12,25,21,690250,46,20240627,21-24,저녁
합계,6343,6343,54592,89697,7668555050,144289,20240627,,
00:00 ~ 2:59,0,0,0,0,0,0,20240628,0-3,심야
3:00 ~ 5:59,0,0,0,0,0,0,20240628,3-6,심야
6:00 ~ 8:59,0,0,0,0,0,0,20240628,6-9,심야
9:00 ~ 11:59,708,708,1906,5061,108884030,6967,20240628,9-12,주간
12:00 ~ 14:59,1383,1383,7745,11811,578813480,19556,20240628,12-15,주간
15:00 ~ 17:59,1669,1669,7566,13788,499574605,21354,20240628,15-18,주간
18:00 ~ 20:59,2521,2521,23354,24315,1449913980,47669,20240628,18-21,저녁
21:00 ~ 23:59,9,9,9,68,825100,77,20240628,21-24,저녁
합계,6290,6290,40580,55043,2638011195,95623,20240628,,
00:00 ~ 2:59,0,0,0,0,0,0,20240629,0-3,심야
3:00 ~ 5:59,0,0,0,0,0,0,20240629,3-6,심야
6:00 ~ 8:59,0,0,0,0,0,0,20240629,6-9,심야
9:00 ~ 11:59,677,677,1080,3701,95452110,4781,20240629,9-12,주간
12:00 ~ 14:59,1423,1423,7472,10297,531997710,17769,20240629,12-15,주간
15:00 ~ 17:59,1593,1593,9074,9113,418024170,18187,20240629,15-18,주간
18:00 ~ 20:59,2211,2211,15786,14154,1066086140,29940,20240629,18-21,저녁
21:00 ~ 23:59,10,10,9,60,731500,69,20240629,21-24,저녁
합계,5914,5914,33421,37325,2112291630,70746,20240629,,
00:00 ~ 2:59,0,0,0,0,0,0,20240630,0-3,심야
3:00 ~ 5:59,0,0,0,0,0,0,20240630,3-6,심야
6:00 ~ 8:59,0,0,0,0,0,0,20240630,6-9,심야
9:00 ~ 11:59,597,597,1109,2602,76582100,3711,20240630,9-12,주간
12:00 ~ 14:59,1326,1326,6402,7982,425570065,14384,20240630,12-15,주간
15:00 ~ 17:59,1444,1444,5242,7698,427698770,12940,20240630,15-18,주간
18:00 ~ 20:59,2148,2148,12284,12047,893465670,24331,20240630,18-21,저녁
21:00 ~ 23:59,9,9,9,33,444600,42,20240630,21-24,저녁
합계,5524,5524,25046,30362,1823761205,55408,20240630,,
00:00 ~ 2:59,0,0,0,0,0,0,20240701,0-3,심야
3:00 ~ 5:59,0,0,0,0,0,0,20240701,3-6,심야
6:00 ~ 8:59,0,0,0,0,0,0,20240701,6-9,심야
9:00 ~ 11:59,685,685,1760,3263,104418480,5023,20240701,9-12,주간
12:00 ~ 14:59,1319,1319,5699,10963,565973810,16662,20240701,12-15,주간
15:00 ~ 17:59,1611,1611,5038,15103,1227856505,20141,20240701,15-18,주간
18:00 ~ 20:59,2520,2520,29183,24058,1712865050,53241,20240701,18-21,저녁
21:00 ~ 23:59,20,20,29,197,2042350,226,20240701,21-24,저녁
합계,6155,6155,41709,53584,3613156195,95293,20240701,,
00:00 ~ 2:59,0,0,0,0,0,0,20240702,0-3,심야
3:00 ~ 5:59,0,0,0,0,0,0,20240702,3-6,심야
6:00 ~ 8:59,0,0,0,0,0,0,20240702,6-9,심야
9:00 ~ 11:59,749,749,2013,6430,189639950,8443,20240702,9-12,주간
12:00 ~ 14:59,1425,1425,9803,14921,669596430,24724,20240702,12-15,주간
15:00 ~ 17:59,1604,1604,6196,12944,680381230,19140,20240702,15-18,주간
18:00 ~ 20:59,2475,2475,20759,28468,1451278840,49227,20240702,18-21,저녁
21:00 ~ 23:59,15,15,16,87,1416000,103,20240702,21-24,저녁
합계,6268,6268,38787,62850,2992312450,101637,20240702,,
00:00 ~ 2:59,0,0,0,0,0,0,20240703,0-3,심야
3:00 ~ 5:59,0,0,0,0,0,0,20240703,3-6,심야
6:00 ~ 8:59,0,0,0,0,0,0,20240703,6-9,심야
9:00 ~ 11:59,726,726,1722,5654,117072070,7376,20240703,9-12,주간
12:00 ~ 14:59,1448,1448,9052,17776,804021055,26828,20240703,12-15,주간
15:00 ~ 17:59,1647,1647,6820,13123,490509000,19943,20240703,15-18,주간
18:00 ~ 20:59,2616,2616,29309,28898,1564633521,58207,20240703,18-21,저녁
21:00 ~ 23:59,24,24,32,68,432550,100,20240703,21-24,저녁
합계,6461,6461,46935,65519,2976668196,112454,20240703,,
00:00 ~ 2:59,0,0,0,0,0,0,20240704,0-3,심야
3:00 ~ 5:59,0,0,0,0,0,0,20240704,3-6,심야
6:00 ~ 8:59,0,0,0,0,0,0,20240704,6-9,심야
9:00 ~ 11:59,766,766,2019,5586,115210210,7605,20240704,9-12,주간
12:00 ~ 14:59,1508,1508,7643,14639,753874150,22282,20240704,12-15,주간
15:00 ~ 17:59,1700,1700,5529,15182,598961140,20711,20240704,15-18,주간
18:00 ~ 20:59,2452,2452,18628,22682,1286087711,41310,20240704,18-21,저녁
21:00 ~ 23:59,19,19,32,100,1500900,132,20240704,21-24,저녁
합계,6445,6445,33851,58189,2755634111,92040,20240704,,
00:00 ~ 2:59,0,0,0,0,0,0,20240705,0-3,심야
3:00 ~ 5:59,0,0,0,0,0,0,20240705,3-6,심야
6:00 ~ 8:59,0,0,0,0,0,0,20240705,6-9,심야
9:00 ~ 11:59,726,726,1691,4808,114692550,6499,20240705,9-12,주간
12:00 ~ 14:59,1524,1524,6868,15119,676788750,21987,20240705,12-15,주간
15:00 ~ 17:59,1696,1696,8304,15480,787832350,23784,20240705,15-18,주간
18:00 ~ 20:59,2514,2514,18310,28183,1655560220,46493,20240705,18-21,저녁
21:00 ~ 23:59,28,28,22,83,1265550,105,20240705,21-24,저녁
합계,6488,6488,35195,63673,3236139420,98868,20240705,,
00:00 ~ 2:59,0,0,0,0,0,0,20240706,0-3,심야
3:00 ~ 5:59,0,0,0,0,0,0,20240706,3-6,심야
6:00 ~ 8:59,0,0,0,0,0,0,20240706,6-9,심야
9:00 ~ 11:59,691,691,1798,3016,104385800,4814,20240706,9-12,주간
12:00 ~ 14:59,1493,1493,6983,9777,516577370,16760,20240706,12-15,주간
15:00 ~ 17:59,1653,1653,7937,9060,427110400,16997,20240706,15-18,주간
18:00 ~ 20:59,2235,2235,14376,11739,914130860,26115,20240706,18-21,저녁
21:00 ~ 23:59,35,35,44,242,1106500,286,20240706,21-24,저녁
합계,6107,6107,31138,33834,1963310930,64972,20240706,,
00:00 ~ 2:59,0,0,0,0,0,0,20240707,0-3,심야
3:00 ~ 5:59,0,0,0,0,0,0,20240707,3-6,심야
6:00 ~ 8:59,0,0,0,0,0,0,20240707,6-9,심야
9:00 ~ 11:59,707,707,1835,2686,98871710,4521,20240707,9-12,주간
12:00 ~ 14:59,1418,1418,6835,8582,458946770,15417,20240707,12-15,주간
15:00 ~ 17:59,1541,1541,4247,7046,336845920,11293,20240707,15-18,주간
18:00 ~ 20:59,2146,2146,16195,5772,788581050,21967,20240707,18-21,저녁
21:00 ~ 23:59,30,30,8,103,614900,111,20240707,21-24,저녁
합계,5842,5842,29120,24189,1683860350,53309,20240707,,
00:00 ~ 2:59,0,0,0,0,0,0,20240708,0-3,심야
3:00 ~ 5:59,0,0,0,0,0,0,20240708,3-6,심야
6:00 ~ 8:59,0,0,0,0,0,0,20240708,6-9,심야
9:00 ~ 11:59,741,741,1660,3287,104904950,4947,20240708,9-12,주간
12:00 ~ 14:59,1342,1342,5978,19123,1441825200,25101,20240708,12-15,주간
15:00 ~ 17:59,1575,1575,6171,11877,547155130,18048,20240708,15-18,주간
18:00 ~ 20:59,2410,2410,17351,33517,1269287100,50868,20240708,18-21,저녁
21:00 ~ 23:59,36,36,88,757,32488400,845,20240708,21-24,저녁
합계,6104,6104,31248,68561,3395660780,99809,20240708,,
00:00 ~ 2:59,0,0,0,0,0,0,20240709,0-3,심야
3:00 ~ 5:59,0,0,0,0,0,0,20240709,3-6,심야
6:00 ~ 8:59,0,0,0,0,0,0,20240709,6-9,심야
9:00 ~ 11:59,813,813,3489,3904,125048620,7393,20240709,9-12,주간
12:00 ~ 14:59,1448,1448,8832,12456,862616155,21288,20240709,12-15,주간
15:00 ~ 17:59,1673,1673,6466,14457,687683260,20923,20240709,15-18,주간
18:00 ~ 20:59,2521,2521,27461,27307,1456377680,54768,20240709,18-21,저녁
21:00 ~ 23:59,32,32,50,177,3504100,227,20240709,21-24,저녁
합계,6487,6487,46298,58301,3135229815,104599,20240709,,
00:00 ~ 2:59,0,0,0,0,0,0,20240710,0-3,심야
3:00 ~ 5:59,0,0,0,0,0,0,20240710,3-6,심야
6:00 ~ 8:59,0,0,0,0,0,0,20240710,6-9,심야
9:00 ~ 11:59,787,787,3553,3895,130955090,7448,20240710,9-12,주간
12:00 ~ 14:59,1530,1530,7036,16661,1158072745,23697,20240710,12-15,주간
15:00 ~ 17:59,1704,1704,6344,12112,465944720,18456,20240710,15-18,주간
18:00 ~ 20:59,2558,2558,19603,29086,1480360312,48689,20240710,18-21,저녁
21:00 ~ 23:59,35,35,43,144,2235800,187,20240710,21-24,저녁
합계,6614,6614,36579,61898,3237568667,98477,20240710,,
00:00 ~ 2:59,0,0,0,0,0,0,20240711,0-3,심야
3:00 ~ 5:59,0,0,0,0,0,0,20240711,3-6,심야
6:00 ~ 8:59,0,0,0,0,0,0,20240711,6-9,심야
9:00 ~ 11:59,793,793,3768,5239,138181640,9007,20240711,9-12,주간
12:00 ~ 14:59,1486,1486,7285,15350,1017997585,22635,20240711,12-15,주간
15:00 ~ 17:59,1688,1688,5534,13829,435502790,19363,20240711,15-18,주간
18:00 ~ 20:59,2524,2524,17271,30992,1762554630,48263,20240711,18-21,저녁
21:00 ~ 23:59,33,33,35,120,1572300,155,20240711,21-24,저녁
합계,6524,6524,33893,65530,3355808945,99423,20240711,,
00:00 ~ 2:59,0,0,0,0,0,0,20240712,0-3,심야
3:00 ~ 5:59,0,0,0,0,0,0,20240712,3-6,심야
6:00 ~ 8:59,0,0,0,0,0,0,20240712,6-9,심야
9:00 ~ 11:59,772,772,3808,4396,118369180,8204,20240712,9-12,주간
12:00 ~ 14:59,1592,1592,9182,20675,1423211950,29857,20240712,12-15,주간
15:00 ~ 17:59,1755,1755,7229,16921,767718170,24150,20240712,15-18,주간
18:00 ~ 20:59,2493,2493,21743,24304,1257232260,46047,20240712,18-21,저녁
21:00 ~ 23:59,24,24,51,111,1934850,162,20240712,21-24,저녁
합계,6636,6636,42013,66407,3568466410,108420,20240712,,
00:00 ~ 2:59,0,0,0,0,0,0,20240713,0-3,심야
3:00 ~ 5:59,0,0,0,0,0,0,20240713,3-6,심야
6:00 ~ 8:59,0,0,0,0,0,0,20240713,6-9,심야
9:00 ~ 11:59,740,740,2668,3042,95248650,5710,20240713,9-12,주간
12:00 ~ 14:59,1537,1537,8301,12842,807271750,21143,20240713,12-15,주간
15:00 ~ 17:59,1667,1667,7359,11851,449846315,19210,20240713,15-18,주간
18:00 ~ 20:59,2172,2172,11519,15650,919728570,27169,20240713,18-21,저녁
21:00 ~ 23:59,24,24,39,64,1275400,103,20240713,21-24,저녁
합계,6140,6140,29886,43449,2273370685,73335,20240713,,
00:00 ~ 2:59,0,0,0,0,0,0,20240714,0-3,심야
3:00 ~ 5:59,0,0,0,0,0,0,20240714,3-6,심야
6:00 ~ 8:59,0,0,0,0,0,0,20240714,6-9,심야
9:00 ~ 11:59,740,740,2208,3749,104242710,5957,20240714,9-12,주간
12:00 ~ 14:59,1441,1441,7664,8857,559836940,16521,20240714,12-15,주간
15:00 ~ 17:59,1526,1526,5351,8638,395337785,13989,20240714,15-18,주간
18:00 ~ 20:59,2150,2150,24562,-3662,710536040,20900,20240714,18-21,저녁
21:00 ~ 23:59,17,17,5,39,793000,44,20240714,21-24,저녁
합계,5874,5874,39790,17621,1770746475,57411,20240714,,
00:00 ~ 2:59,0,0,0,0,0,0,20240715,0-3,심야
3:00 ~ 5:59,0,0,0,0,0,0,20240715,3-6,심야
6:00 ~ 8:59,0,0,0,0,0,0,20240715,6-9,심야
9:00 ~ 11:59,807,807,1835,4274,111609890,6109,20240715,9-12,주간
12:00 ~ 14:59,1449,1449,6448,10480,528527420,16928,20240715,12-15,주간
15:00 ~ 17:59,1674,1674,7337,18832,1464432605,26169,20240715,15-18,주간
18:00 ~ 20:59,2453,2453,16900,28041,1685997430,44941,20240715,18-21,저녁
21:00 ~ 23:59,26,26,19,102,784100,121,20240715,21-24,저녁
합계,6409,6409,32539,61729,3791351445,94268,20240715,,
00:00 ~ 2:59,0,0,0,0,0,0,20240716,0-3,심야
3:00 ~ 5:59,0,0,0,0,0,0,20240716,3-6,심야
6:00 ~ 8:59,0,0,0,0,0,0,20240716,6-9,심야
9:00 ~ 11:59,812,812,4431,3766,158318500,8197,20240716,9-12,주간
12:00 ~ 14:59,1550,1550,10029,24182,1824260650,34211,20240716,12-15,주간
15:00 ~ 17:59,1722,1722,7821,18954,901648045,26775,20240716,15-18,주간
18:00 ~ 20:59,2601,2601,21729,56714,4372209319,78443,20240716,18-21,저녁
21:00 ~ 23:59,27,27,34,235,1723700,269,20240716,21-24,저녁
합계,6712,6712,44044,103851,7258160214,147895,20240716,,
00:00 ~ 2:59,0,0,0,0,0,0,20240717,0-3,심야
3:00 ~ 5:59,0,0,0,0,0,0,20240717,3-6,심야
6:00 ~ 8:59,0,0,0,0,0,0,20240717,6-9,심야
9:00 ~ 11:59,818,818,4266,4304,115457750,8570,20240717,9-12,주간
12:00 ~ 14:59,1487,1487,10929,12936,882786405,23865,20240717,12-15,주간
15:00 ~ 17:59,1804,1804,11771,17798,1112520400,29569,20240717,15-18,주간
18:00 ~ 20:59,2557,2557,22204,30700,1933648790,52904,20240717,18-21,저녁
21:00 ~ 23:59,23,23,51,150,1791400,201,20240717,21-24,저녁
합계,6689,6689,49221,65888,4046204745,115109,20240717,,
00:00 ~ 2:59,0,0,0,0,0,0,20240718,0-3,심야
3:00 ~ 5:59,0,0,0,0,0,0,20240718,3-6,심야
6:00 ~ 8:59,0,0,0,0,0,0,20240718,6-9,심야
9:00 ~ 11:59,853,853,3967,5997,109723940,9964,20240718,9-12,주간
12:00 ~ 14:59,1576,1576,11368,23326,1386505737,34694,20240718,12-15,주간
15:00 ~ 17:59,1796,1796,10177,27280,2666557180,37457,20240718,15-18,주간
18:00 ~ 20:59,2527,2527,30755,42667,3335597030,73422,20240718,18-21,저녁
21:00 ~ 23:59,26,26,137,44,1780200,181,20240718,21-24,저녁
합계,6778,6778,56404,99314,7500164087,155718,20240718,,
00:00 ~ 2:59,0,0,0,0,0,0,20240719,0-3,심야
3:00 ~ 5:59,0,0,0,0,0,0,20240719,3-6,심야
6:00 ~ 8:59,0,0,0,0,0,0,20240719,6-9,심야
9:00 ~ 11:59,798,798,3993,5018,114963090,9011,20240719,9-12,주간
12:00 ~ 14:59,1660,1660,8784,17490,1087942980,26274,20240719,12-15,주간
15:00 ~ 17:59,1922,1922,9643,18929,640863630,28572,20240719,15-18,주간
18:00 ~ 20:59,2680,2680,20768,28763,1835452020,49531,20240719,18-21,저녁
21:00 ~ 23:59,27,27,37,61,1668000,98,20240719,21-24,저녁
합계,7087,7087,43225,70261,3680889720,113486,20240719,,
00:00 ~ 2:59,0,0,0,0,0,0,20240720,0-3,심야
3:00 ~ 5:59,0,0,0,0,0,0,20240720,3-6,심야
6:00 ~ 8:59,0,0,0,0,0,0,20240720,6-9,심야
9:00 ~ 11:59,811,811,3246,4182,110394180,7428,20240720,9-12,주간
12:00 ~ 14:59,1620,1620,8763,12993,780280625,21756,20240720,12-15,주간
15:00 ~ 17:59,1799,1799,11725,12432,469895860,24157,20240720,15-18,주간
18:00 ~ 20:59,2261,2261,14263,16988,1187189530,31251,20240720,18-21,저녁
21:00 ~ 23:59,19,19,53,91,828900,144,20240720,21-24,저녁
합계,6510,6510,38050,46686,2548589095,84736,20240720,,
00:00 ~ 2:59,0,0,0,0,0,0,20240721,0-3,심야
3:00 ~ 5:59,0,0,0,0,0,0,20240721,3-6,심야
6:00 ~ 8:59,0,0,0,0,0,0,20240721,6-9,심야
9:00 ~ 11:59,773,773,2683,3306,105398490,5989,20240721,9-12,주간
12:00 ~ 14:59,1564,1564,8408,10053,607209395,18461,20240721,12-15,주간
15:00 ~ 17:59,1700,1700,7349,9492,430717830,16841,20240721,15-18,주간
18:00 ~ 20:59,2184,2184,12709,11625,846007070,24334,20240721,18-21,저녁
21:00 ~ 23:59,19,19,19,93,899000,112,20240721,21-24,저녁
합계,6240,6240,31168,34569,1990231785,65737,20240721,,
00:00 ~ 2:59,0,0,0,0,0,0,20240722,0-3,심야
3:00 ~ 5:59,0,0,0,0,0,0,20240722,3-6,심야
6:00 ~ 8:59,0,0,0,0,0,0,20240722,6-9,심야
9:00 ~ 11:59,822,822,2062,4330,117131910,6392,20240722,9-12,주간
12:00 ~ 14:59,1558,1558,6115,9758,524441817,15873,20240722,12-15,주간
15:00 ~ 17:59,1734,1734,6385,9725,384603017,16110,20240722,15-18,주간
18:00 ~ 20:59,2437,2437,14128,18415,820072260,32543,20240722,18-21,저녁
21:00 ~ 23:59,17,17,17,98,675100,115,20240722,21-24,저녁
합계,6568,6568,28707,42326,1846924104,71033,20240722,,
00:00 ~ 2:59,0,0,0,0,0,0,20240723,0-3,심야
3:00 ~ 5:59,0,0,0,0,0,0,20240723,3-6,심야
6:00 ~ 8:59,0,0,0,0,0,0,20240723,6-9,심야
9:00 ~ 11:59,877,877,4071,7277,159329010,11348,20240723,9-12,주간
12:00 ~ 14:59,1631,1631,9564,13051,589702984,22615,20240723,12-15,주간
15:00 ~ 17:59,1807,1807,8546,24932,2208699175,33478,20240723,15-18,주간
18:00 ~ 20:59,2667,2667,24930,24415,998576060,49345,20240723,18-21,저녁
21:00 ~ 23:59,22,22,73,79,390100,152,20240723,21-24,저녁
합계,7004,7004,47184,69754,3956697329,116938,20240723,,
00:00 ~ 2:59,0,0,0,0,0,0,20240724,0-3,심야
3:00 ~ 5:59,0,0,0,0,0,0,20240724,3-6,심야
6:00 ~ 8:59,0,0,0,0,0,0,20240724,6-9,심야
9:00 ~ 11:59,887,887,4507,5874,169638270,10381,20240724,9-12,주간
12:00 ~ 14:59,1646,1646,7410,12329,667384934,19739,20240724,12-15,주간
15:00 ~ 17:59,1880,1880,10410,34118,3182401025,44528,20240724,15-18,주간
18:00 ~ 20:59,2662,2662,17569,26112,1115848770,43681,20240724,18-21,저녁
21:00 ~ 23:59,26,26,92,73,880850,165,20240724,21-24,저녁
합계,7101,7101,39988,78506,5136153849,118494,20240724,,
00:00 ~ 2:59,0,0,0,0,0,0,20240725,0-3,심야
3:00 ~ 5:59,0,0,0,0,0,0,20240725,3-6,심야
6:00 ~ 8:59,0,0,0,0,0,0,20240725,6-9,심야
9:00 ~ 11:59,864,864,4653,6095,136534560,10748,20240725,9-12,주간
12:00 ~ 14:59,1744,1744,11102,22060,1585554880,33162,20240725,12-15,주간
15:00 ~ 17:59,1971,1971,13969,23438,1539943965,37407,20240725,15-18,주간
18:00 ~ 20:59,2713,2713,25741,48768,3814309550,74509,20240725,18-21,저녁
21:00 ~ 23:59,23,23,182,356,1200600,538,20240725,21-24,저녁
합계,7315,7315,55647,100717,7077543555,156364,20240725,,
00:00 ~ 2:59,0,0,0,0,0,0,20240726,0-3,심야
3:00 ~ 5:59,0,0,0,0,0,0,20240726,3-6,심야
6:00 ~ 8:59,0,0,0,0,0,0,20240726,6-9,심야
9:00 ~ 11:59,867,867,3911,4950,161852330,8861,20240726,9-12,주간
12:00 ~ 14:59,1756,1756,9740,15152,778787075,24892,20240726,12-15,주간
15:00 ~ 17:59,1979,1979,14523,22520,1126943015,37043,20240726,15-18,주간
18:00 ~ 20:59,2682,2682,21637,32665,1452403800,54302,20240726,18-21,저녁
21:00 ~ 23:59,22,22,56,78,2326700,134,20240726,21-24,저녁
합계,7306,7306,49867,75365,3522312920,125232,20240726,,
00:00 ~ 2:59,0,0,0,0,0,0,20240727,0-3,심야
3:00 ~ 5:59,0,0,0,0,0,0,20240727,3-6,심야
6:00 ~ 8:59,0,0,0,0,0,0,20240727,6-9,심야
9:00 ~ 11:59,774,774,3178,4318,115338040,7496,20240727,9-12,주간
12:00 ~ 14:59,1615,1615,9749,13543,606950185,23292,20240727,12-15,주간
15:00 ~ 17:59,1845,1845,9929,13690,575682719,23619,20240727,15-18,주간
18:00 ~ 20:59,2301,2301,13557,15724,865298312,29281,20240727,18-21,저녁
21:00 ~ 23:59,16,16,27,207,723550,234,20240727,21-24,저녁
합계,6551,6551,36440,47482,2163992806,83922,20240727,,
00:00 ~ 2:59,0,0,0,0,0,0,20240728,0-3,심야
3:00 ~ 5:59,0,0,0,0,0,0,20240728,3-6,심야
6:00 ~ 8:59,0,0,0,0,0,0,20240728,6-9,심야
9:00 ~ 11:59,763,763,3082,3170,110495370,6252,20240728,9-12,주간
12:00 ~ 14:59,1568,1568,8320,9737,506587954,18057,20240728,12-15,주간
15:00 ~ 17:59,1721,1721,8034,10163,416605208,18197,20240728,15-18,주간
18:00 ~ 20:59,2193,2193,16336,6110,732534096,22446,20240728,18-21,저녁
21:00 ~ 23:59,19,19,60,163,1499750,223,20240728,21-24,저녁
합계,6264,6264,35832,29343,1767722378,65175,20240728,,
00:00 ~ 2:59,0,0,0,0,0,0,20240729,0-3,심야
3:00 ~ 5:59,0,0,0,0,0,0,20240729,3-6,심야
6:00 ~ 8:59,0,0,0,0,0,0,20240729,6-9,심야
9:00 ~ 11:59,759,759,2439,4744,116076370,7183,20240729,9-12,주간
12:00 ~ 14:59,1522,1522,7422,11385,475424795,18807,20240729,12-15,주간
15:00 ~ 17:59,1698,1698,12441,33590,3350936230,46031,20240729,15-18,주간
18:00 ~ 20:59,2442,2442,21452,38767,3987279392,60219,20240729,18-21,저녁
21:00 ~ 23:59,16,16,31,72,1231600,103,20240729,21-24,저녁
합계,6437,6437,43785,88558,7930948387,132343,20240729,,
00:00 ~ 2:59,0,0,0,0,0,0,20240730,0-3,심야
3:00 ~ 5:59,0,0,0,0,0,0,20240730,3-6,심야
6:00 ~ 8:59,0,0,0,0,0,0,20240730,6-9,심야
9:00 ~ 11:59,763,763,3877,6565,124618650,10442,20240730,9-12,주간
12:00 ~ 14:59,1516,1516,8073,10562,524561695,18635,20240730,12-15,주간
15:00 ~ 17:59,1785,1785,9462,23015,2184751720,32477,20240730,15-18,주간
18:00 ~ 20:59,2569,2569,30352,58054,6640889130,88406,20240730,18-21,저녁
21:00 ~ 23:59,29,29,79,264,1428150,343,20240730,21-24,저녁
합계,6662,6662,51843,98460,9476249345,150303,20240730,,
00:00 ~ 2:59,0,0,0,0,0,0,20240731,0-3,심야
3:00 ~ 5:59,0,0,0,0,0,0,20240731,3-6,심야
6:00 ~ 8:59,0,0,0,0,0,0,20240731,6-9,심야
9:00 ~ 11:59,774,774,4649,3405,124261630,8054,20240731,9-12,주간
12:00 ~ 14:59,1581,1581,13209,9372,419829853,22581,20240731,12-15,주간
15:00 ~ 17:59,1867,1867,12661,21146,1761009160,33807,20240731,15-18,주간
18:00 ~ 20:59,2543,2543,27306,33146,3106315549,60452,20240731,18-21,저녁
21:00 ~ 23:59,24,24,77,415,1531200,492,20240731,21-24,저녁
합계,6789,6789,57902,67484,5412947392,125386,20240731,,
00:00 ~ 2:59,0,0,0,0,0,0,20240801,0-3,심야
3:00 ~ 5:59,0,0,0,0,0,0,20240801,3-6,심야
6:00 ~ 8:59,0,0,0,0,0,0,20240801,6-9,심야
9:00 ~ 11:59,820,820,3891,4921,140551780,8812,20240801,9-12,주간
12:00 ~ 14:59,1668,1668,12888,14755,568175980,27643,20240801,12-15,주간
15:00 ~ 17:59,1922,1922,12652,21536,1494322600,34188,20240801,15-18,주간
18:00 ~ 20:59,2623,2623,28515,41071,1895755200,69586,20240801,18-21,저녁
21:00 ~ 23:59,26,26,59,79,1337900,138,20240801,21-24,저녁
합계,7059,7059,58005,82362,4100143460,140367,20240801,,
00:00 ~ 2:59,0,0,0,0,0,0,20240802,0-3,심야
3:00 ~ 5:59,0,0,0,0,0,0,20240802,3-6,심야
6:00 ~ 8:59,0,0,0,0,0,0,20240802,6-9,심야
9:00 ~ 11:59,748,748,3430,4056,127676330,7486,20240802,9-12,주간
12:00 ~ 14:59,1610,1610,8337,14748,486774120,23085,20240802,12-15,주간
15:00 ~ 17:59,1908,1908,10276,20005,1211101395,30281,20240802,15-18,주간
18:00 ~ 20:59,2470,2470,22657,29946,1693100222,52603,20240802,18-21,저녁
21:00 ~ 23:59,25,25,52,332,2921000,384,20240802,21-24,저녁
합계,6761,6761,44752,69087,3521573067,113839,20240802,,
00:00 ~ 2:59,0,0,0,0,0,0,20240803,0-3,심야
3:00 ~ 5:59,0,0,0,0,0,0,20240803,3-6,심야
6:00 ~ 8:59,0,0,0,0,0,0,20240803,6-9,심야
9:00 ~ 11:59,698,698,2903,3507,121687150,6410,20240803,9-12,주간
12:00 ~ 14:59,1533,1533,9412,8391,406901880,17803,20240803,12-15,주간
15:00 ~ 17:59,1769,1769,10031,11135,546823130,21166,20240803,15-18,주간
18:00 ~ 20:59,2166,2166,22856,4679,805639550,27535,20240803,18-21,저녁
21:00 ~ 23:59,15,15,27,270,5012850,297,20240803,21-24,저녁
합계,6181,6181,45229,27982,1886064560,73211,20240803,,
00:00 ~ 2:59,0,0,0,0,0,0,20240804,0-3,심야
3:00 ~ 5:59,0,0,0,0,0,0,20240804,3-6,심야
6:00 ~ 8:59,0,0,0,0,0,0,20240804,6-9,심야
9:00 ~ 11:59,653,653,2294,2736,83964670,5030,20240804,9-12,주간
12:00 ~ 14:59,1406,1406,7071,7282,374998425,14353,20240804,12-15,주간
15:00 ~ 17:59,1622,1622,7146,7855,358338885,15001,20240804,15-18,주간
18:00 ~ 20:59,2074,2074,11622,8260,418907100,19882,20240804,18-21,저녁
21:00 ~ 23:59,16,16,15,90,3267200,105,20240804,21-24,저녁
합계,5771,5771,28148,26223,1239476280,54371,20240804,,
00:00 ~ 2:59,0,0,0,0,0,0,20240805,0-3,심야
3:00 ~ 5:59,0,0,0,0,0,0,20240805,3-6,심야
6:00 ~ 8:59,0,0,0,0,0,0,20240805,6-9,심야
9:00 ~ 11:59,667,667,1553,5888,81475070,7441,20240805,9-12,주간
12:00 ~ 14:59,1411,1411,7125,19368,635189530,26493,20240805,12-15,주간
15:00 ~ 17:59,1672,1672,7682,14499,945403140,22181,20240805,15-18,주간
18:00 ~ 20:59,2324,2324,18199,26817,2070336870,45016,20240805,18-21,저녁
21:00 ~ 23:59,17,17,15,101,3228150,116,20240805,21-24,저녁
합계,6091,6091,34574,66673,3735632760,101247,20240805,,
00:00 ~ 2:59,0,0,0,0,0,0,20240806,0-3,심야
3:00 ~ 5:59,0,0,0,0,0,0,20240806,3-6,심야
6:00 ~ 8:59,0,0,0,0,0,0,20240806,6-9,심야
9:00 ~ 11:59,732,732,3804,3931,103551270,7735,20240806,9-12,주간
12:00 ~ 14:59,1480,1480,9605,14398,649046022,24003,20240806,12-15,주간
15:00 ~ 17:59,1822,1822,13509,27858,2389300665,41367,20240806,15-18,주간
18:00 ~ 20:59,2564,2564,29837,43741,3009663380,73578,20240806,18-21,저녁
21:00 ~ 23:59,17,17,25,71,1724900,96,20240806,21-24,저녁
합계,6615,6615,56780,89999,6153286237,146779,20240806,,
00:00 ~ 2:59,0,0,0,0,0,0,20240807,0-3,심야
3:00 ~ 5:59,0,0,0,0,0,0,20240807,3-6,심야
6:00 ~ 8:59,0,0,0,0,0,0,20240807,6-9,심야
9:00 ~ 11:59,710,710,4333,3004,100932030,7337,20240807,9-12,주간
12:00 ~ 14:59,1521,1521,8160,12304,640999350,20464,20240807,12-15,주간
15:00 ~ 17:59,1878,1878,12668,26272,2413737830,38940,20240807,15-18,주간
18:00 ~ 20:59,2574,2574,24723,48260,4571263190,72983,20240807,18-21,저녁
21:00 ~ 23:59,19,19,85,31,1454850,116,20240807,21-24,저녁
합계,6702,6702,49969,89871,7728387250,139840,20240807,,
00:00 ~ 2:59,0,0,0,0,0,0,20240808,0-3,심야
3:00 ~ 5:59,0,0,0,0,0,0,20240808,3-6,심야
6:00 ~ 8:59,0,0,0,0,0,0,20240808,6-9,심야
9:00 ~ 11:59,734,734,3787,3230,93918100,7017,20240808,9-12,주간
12:00 ~ 14:59,1570,1570,9911,18389,1540497490,28300,20240808,12-15,주간
15:00 ~ 17:59,1881,1881,13589,23599,1818850980,37188,20240808,15-18,주간
18:00 ~ 20:59,2553,2553,21275,37144,2307816510,58419,20240808,18-21,저녁
21:00 ~ 23:59,19,19,59,79,1330150,138,20240808,21-24,저녁
합계,6757,6757,48621,82441,5762413230,131062,20240808,,
00:00 ~ 2:59,0,0,0,0,0,0,20240809,0-3,심야
3:00 ~ 5:59,0,0,0,0,0,0,20240809,3-6,심야
6:00 ~ 8:59,1,1,0,1,0,1,20240809,6-9,심야
9:00 ~ 11:59,720,720,4105,2945,102263060,7050,20240809,9-12,주간
12:00 ~ 14:59,1550,1550,12391,19455,1535605310,31846,20240809,12-15,주간
15:00 ~ 17:59,1924,1924,11998,22455,1008913232,34453,20240809,15-18,주간
18:00 ~ 20:59,2545,2545,27390,49341,4024678690,76731,20240809,18-21,저녁
21:00 ~ 23:59,14,14,60,64,1692400,124,20240809,21-24,저녁
합계,6754,6754,55944,94261,6673152692,150205,20240809,,
00:00 ~ 2:59,0,0,0,0,0,0,20240810,0-3,심야
3:00 ~ 5:59,0,0,0,0,0,0,20240810,3-6,심야
6:00 ~ 8:59,1,1,0,2,0,2,20240810,6-9,심야
9:00 ~ 11:59,668,668,2544,3146,89067220,5690,20240810,9-12,주간
12:00 ~ 14:59,1460,1460,9096,11508,630828775,20604,20240810,12-15,주간
15:00 ~ 17:59,1835,1835,9736,13785,583081055,23521,20240810,15-18,주간
18:00 ~ 20:59,2246,2246,14688,18195,1297968050,32883,20240810,18-21,저녁
21:00 ~ 23:59,9,9,19,19,417600,38,20240810,21-24,저녁
합계,6219,6219,36083,46655,2601362700,82738,20240810,,
00:00 ~ 2:59,0,0,0,0,0,0,20240811,0-3,심야
3:00 ~ 5:59,0,0,0,0,0,0,20240811,3-6,심야
6:00 ~ 8:59,1,1,0,7,0,7,20240811,6-9,심야
9:00 ~ 11:59,571,571,2425,2433,68202800,4858,20240811,9-12,주간
12:00 ~ 14:59,1385,1385,9364,9192,540468500,18556,20240811,12-15,주간
15:00 ~ 17:59,1679,1679,7348,9980,412551615,17328,20240811,15-18,주간
18:00 ~ 20:59,2194,2194,17161,9565,778499650,26726,20240811,18-21,저녁
21:00 ~ 23:59,15,15,14,47,1067300,61,20240811,21-24,저녁
합계,5845,5845,36312,31224,1800789865,67536,20240811,,
00:00 ~ 2:59,0,0,0,0,0,0,20240812,0-3,심야
3:00 ~ 5:59,0,0,0,0,0,0,20240812,3-6,심야
6:00 ~ 8:59,1,1,0,1,0,1,20240812,6-9,심야
9:00 ~ 11:59,613,613,1468,3645,88290685,5113,20240812,9-12,주간
12:00 ~ 14:59,1356,1356,8787,9228,657849070,18015,20240812,12-15,주간
15:00 ~ 17:59,1760,1760,8262,15482,796060345,23744,20240812,15-18,주간
18:00 ~ 20:59,2379,2379,21385,110332,13520056050,131717,20240812,18-21,저녁
21:00 ~ 23:59,11,11,9,24,589350,33,20240812,21-24,저녁
합계,6120,6120,39911,138712,15062845500,178623,20240812,,
00:00 ~ 2:59,0,0,0,0,0,0,20240813,0-3,심야
3:00 ~ 5:59,0,0,0,0,0,0,20240813,3-6,심야
6:00 ~ 8:59,1,1,1,2,0,3,20240813,6-9,심야
9:00 ~ 11:59,652,652,3697,2478,88671560,6175,20240813,9-12,주간
12:00 ~ 14:59,1381,1381,9266,15289,673001470,24555,20240813,12-15,주간
15:00 ~ 17:59,1734,1734,8568,13211,483424955,21779,20240813,15-18,주간
18:00 ~ 20:59,2528,2528,26062,30662,1276463900,56724,20240813,18-21,저녁
21:00 ~ 23:59,18,18,64,48,388200,112,20240813,21-24,저녁
합계,6314,6314,47658,61690,2521950085,109348,20240813,,
00:00 ~ 2:59,0,0,0,0,0,0,20240814,0-3,심야
3:00 ~ 5:59,0,0,0,0,0,0,20240814,3-6,심야
6:00 ~ 8:59,1,1,1,-1,0,0,20240814,6-9,심야
9:00 ~ 11:59,664,664,4087,3019,100987825,7106,20240814,9-12,주간
12:00 ~ 14:59,1449,1449,9462,20312,1036495040,29774,20240814,12-15,주간
15:00 ~ 17:59,1861,1861,12334,17497,1014452360,29831,20240814,15-18,주간
18:00 ~ 20:59,2611,2611,28259,39376,2521471642,67635,20240814,18-21,저녁
21:00 ~ 23:59,14,14,22,78,1406400,100,20240814,21-24,저녁
합계,6600,6600,54165,80281,4674813267,134446,20240814,,
00:00 ~ 2:59,0,0,0,0,0,0,20240815,0-3,심야
3:00 ~ 5:59,0,0,0,0,0,0,20240815,3-6,심야
6:00 ~ 8:59,0,0,0,0,0,0,20240815,6-9,심야
9:00 ~ 11:59,593,593,2807,2590,81946200,5397,20240815,9-12,주간
12:00 ~ 14:59,1336,1336,12018,5463,484955045,17481,20240815,12-15,주간
15:00 ~ 17:59,1721,1721,12475,8659,435638605,21134,20240815,15-18,주간
18:00 ~ 20:59,2294,2294,14249,13950,818812681,28199,20240815,18-21,저녁
21:00 ~ 23:59,11,11,34,37,941400,71,20240815,21-24,저녁
합계,5955,5955,41583,30699,1822293931,72282,20240815,,
00:00 ~ 2:59,0,0,0,0,0,0,20240816,0-3,심야
3:00 ~ 5:59,0,0,0,0,0,0,20240816,3-6,심야
6:00 ~ 8:59,1,1,2,0,0,2,20240816,6-9,심야
9:00 ~ 11:59,601,601,2981,3492,104814920,6473,20240816,9-12,주간
12:00 ~ 14:59,1368,1368,7216,14702,734035870,21918,20240816,12-15,주간
15:00 ~ 17:59,1801,1801,16055,15491,1226057185,31546,20240816,15-18,주간
18:00 ~ 20:59,2467,2467,23862,27692,2057909671,51554,20240816,18-21,저녁
21:00 ~ 23:59,15,15,30,33,666700,63,20240816,21-24,저녁
합계,6253,6253,50146,61410,4123484346,111556,20240816,,
00:00 ~ 2:59,0,0,0,0,0,0,20240817,0-3,심야
3:00 ~ 5:59,0,0,0,0,0,0,20240817,3-6,심야
6:00 ~ 8:59,0,0,0,0,0,0,20240817,6-9,심야
9:00 ~ 11:59,559,559,1960,3152,85142490,5112,20240817,9-12,주간
12:00 ~ 14:59,1301,1301,10508,6165,456901090,16673,20240817,12-15,주간
15:00 ~ 17:59,1707,1707,9459,12429,484276410,21888,20240817,15-18,주간
18:00 ~ 20:59,2160,2160,17071,6309,660081575,23380,20240817,18-21,저녁
21:00 ~ 23:59,10,10,9,23,509000,32,20240817,21-24,저녁
합계,5737,5737,39007,28078,1686910565,67085,20240817,,
00:00 ~ 2:59,0,0,0,0,0,0,20240818,0-3,심야
3:00 ~ 5:59,0,0,0,0,0,0,20240818,3-6,심야
6:00 ~ 8:59,0,0,0,0,0,0,20240818,6-9,심야
9:00 ~ 11:59,514,514,1893,1949,74476310,3842,20240818,9-12,주간
12:00 ~ 14:59,1183,1183,9718,3890,374518300,13608,20240818,12-15,주간
15:00 ~ 17:59,1538,1538,10570,5402,353628295,15972,20240818,15-18,주간
18:00 ~ 20:59,2106,2106,10930,8526,574458850,19456,20240818,18-21,저녁
21:00 ~ 23:59,11,11,25,8,160300,33,20240818,21-24,저녁
합계,5352,5352,33136,19775,1377242055,52911,20240818,,
00:00 ~ 2:59,0,0,0,0,0,0,20240819,0-3,심야
3:00 ~ 5:59,0,0,0,0,0,0,20240819,3-6,심야
6:00 ~ 8:59,0,0,0,0,0,0,20240819,6-9,심야
9:00 ~ 11:59,537,537,1556,7191,107530270,8747,20240819,9-12,주간
12:00 ~ 14:59,1138,1138,5733,9235,479978725,14968,20240819,12-15,주간
15:00 ~ 17:59,1633,1633,10086,21815,859134557,31901,20240819,15-18,주간
18:00 ~ 20:59,2413,2413,18759,30551,1693933854,49310,20240819,18-21,저녁
21:00 ~ 23:59,13,13,44,4,-188000,48,20240819,21-24,저녁
합계,5734,5734,36178,68796,3140389406,104974,20240819,,
00:00 ~ 2:59,0,0,0,0,0,0,20240820,0-3,심야
3:00 ~ 5:59,0,0,0,0,0,0,20240820,3-6,심야
6:00 ~ 8:59,0,0,0,0,0,0,20240820,6-9,심야
9:00 ~ 11:59,547,547,2692,3437,72586870,6129,20240820,9-12,주간
12:00 ~ 14:59,1184,1184,6714,11062,584585265,17776,20240820,12-15,주간
15:00 ~ 17:59,1689,1689,7427,14971,484334566,22398,20240820,15-18,주간
18:00 ~ 20:59,2566,2566,19810,31714,1686038543,51524,20240820,18-21,저녁
21:00 ~ 23:59,6,6,24,24,357800,48,20240820,21-24,저녁
합계,5992,5992,36667,61208,2827903044,97875,20240820,,
00:00 ~ 2:59,0,0,0,0,0,0,20240821,0-3,심야
3:00 ~ 5:59,0,0,0,0,0,0,20240821,3-6,심야
6:00 ~ 8:59,1,1,3,-3,0,0,20240821,6-9,심야
9:00 ~ 11:59,537,537,2769,3432,89926120,6201,20240821,9-12,주간
12:00 ~ 14:59,1193,1193,6086,10236,578630197,16322,20240821,12-15,주간
15:00 ~ 17:59,1706,1706,8855,16057,832571392,24912,20240821,15-18,주간
18:00 ~ 20:59,2533,2533,19661,26881,1332063146,46542,20240821,18-21,저녁
21:00 ~ 23:59,14,14,41,60,1036000,101,20240821,21-24,저녁
합계,5984,5984,37415,56663,2834226855,94078,20240821,,
00:00 ~ 2:59,0,0,0,0,0,0,20240822,0-3,심야
3:00 ~ 5:59,0,0,0,0,0,0,20240822,3-6,심야
6:00 ~ 8:59,0,0,0,0,0,0,20240822,6-9,심야
9:00 ~ 11:59,560,560,3210,4238,94691530,7448,20240822,9-12,주간
12:00 ~ 14:59,1200,1200,6809,12311,760323840,19120,20240822,12-15,주간
15:00 ~ 17:59,1695,1695,6999,18194,1214631301,25193,20240822,15-18,주간
18:00 ~ 20:59,2489,2489,20644,31119,2326528443,51763,20240822,18-21,저녁
21:00 ~ 23:59,14,14,110,221,9399400,331,20240822,21-24,저녁
합계,5958,5958,37772,66083,4405574514,103855,20240822,,
00:00 ~ 2:59,0,0,0,0,0,0,20240823,0-3,심야
3:00 ~ 5:59,0,0,0,0,0,0,20240823,3-6,심야
6:00 ~ 8:59,0,0,0,0,0,0,20240823,6-9,심야
9:00 ~ 11:59,564,564,2908,2981,76543020,5889,20240823,9-12,주간
12:00 ~ 14:59,1246,1246,5920,12814,579860214,18734,20240823,12-15,주간
15:00 ~ 17:59,1753,1753,9131,21758,891821985,30889,20240823,15-18,주간
18:00 ~ 20:59,2431,2431,18281,29603,1387343931,47884,20240823,18-21,저녁
21:00 ~ 23:59,10,10,52,88,2200650,140,20240823,21-24,저녁
합계,6004,6004,36292,67244,2937769800,103536,20240823,,
00:00 ~ 2:59,0,0,0,0,0,0,20240824,0-3,심야
3:00 ~ 5:59,0,0,0,0,0,0,20240824,3-6,심야
6:00 ~ 8:59,1,1,4,-4,0,0,20240824,6-9,심야
9:00 ~ 11:59,520,520,1749,3055,74972380,4804,20240824,9-12,주간
12:00 ~ 14:59,1231,1231,6986,7625,421769016,14611,20240824,12-15,주간
15:00 ~ 17:59,1672,1672,9270,15380,584441921,24650,20240824,15-18,주간
18:00 ~ 20:59,2190,2190,10800,14472,808100966,25272,20240824,18-21,저녁
21:00 ~ 23:59,6,6,14,41,1861000,55,20240824,21-24,저녁
합계,5620,5620,28823,40569,1891145283,69392,20240824,,
00:00 ~ 2:59,0,0,0,0,0,0,20240825,0-3,심야
3:00 ~ 5:59,0,0,0,0,0,0,20240825,3-6,심야
6:00 ~ 8:59,0,0,0,0,0,0,20240825,6-9,심야
9:00 ~ 11:59,448,448,1381,1807,63168550,3188,20240825,9-12,주간
12:00 ~ 14:59,1138,1138,5303,7185,414616680,12488,20240825,12-15,주간
15:00 ~ 17:59,1523,1523,7072,9218,486534145,16290,20240825,15-18,주간
18:00 ~ 20:59,2062,2062,7787,11008,627694270,18795,20240825,18-21,저녁
21:00 ~ 23:59,7,7,9,16,499100,25,20240825,21-24,저녁
합계,5178,5178,21552,29234,1592512745,50786,20240825,,
00:00 ~ 2:59,0,0,0,0,0,0,20240826,0-3,심야
3:00 ~ 5:59,0,0,0,0,0,0,20240826,3-6,심야
6:00 ~ 8:59,0,0,0,0,0,0,20240826,6-9,심야
9:00 ~ 11:59,477,477,979,2469,63928080,3448,20240826,9-12,주간
12:00 ~ 14:59,1101,1101,5196,8140,513274660,13336,20240826,12-15,주간
15:00 ~ 17:59,1557,1557,7139,9740,496269830,16879,20240826,15-18,주간
18:00 ~ 20:59,2281,2281,14237,20341,949185075,34578,20240826,18-21,저녁
21:00 ~ 23:59,10,10,21,29,888650,50,20240826,21-24,저녁
합계,5426,5426,27572,40719,2023546295,68291,20240826,,
00:00 ~ 2:59,0,0,0,0,0,0,20240827,0-3,심야
3:00 ~ 5:59,0,0,0,0,0,0,20240827,3-6,심야
6:00 ~ 8:59,1,1,2,-2,0,0,20240827,6-9,심야
9:00 ~ 11:59,494,494,1378,4606,75987230,5984,20240827,9-12,주간
12:00 ~ 14:59,1129,1129,5232,9940,634200840,15172,20240827,12-15,주간
15:00 ~ 17:59,1618,1618,6274,16462,1011900040,22736,20240827,15-18,주간
18:00 ~ 20:59,2444,2444,14986,27507,1885530381,42493,20240827,18-21,저녁
21:00 ~ 23:59,10,10,21,25,659200,46,20240827,21-24,저녁
합계,5696,5696,27893,58538,3608277691,86431,20240827,,
00:00 ~ 2:59,0,0,0,0,0,0,20240828,0-3,심야
3:00 ~ 5:59,0,0,0,0,0,0,20240828,3-6,심야
6:00 ~ 8:59,0,0,0,0,0,0,20240828,6-9,심야
9:00 ~ 11:59,501,501,2896,3808,139491610,6704,20240828,9-12,주간
12:00 ~ 14:59,1119,1119,5468,10055,499268732,15523,20240828,12-15,주간
15:00 ~ 17:59,1649,1649,16216,35835,3651598010,52051,20240828,15-18,주간
18:00 ~ 20:59,2451,2451,20956,43837,2628893070,64793,20240828,18-21,저녁
21:00 ~ 23:59,9,9,39,-6,90000,33,20240828,21-24,저녁
합계,5729,5729,45575,93529,6919341422,139104,20240828,,
00:00 ~ 2:59,0,0,0,0,0,0,20240829,0-3,심야
3:00 ~ 5:59,0,0,0,0,0,0,20240829,3-6,심야
6:00 ~ 8:59,0,0,0,0,0,0,20240829,6-9,심야
9:00 ~ 11:59,499,499,2194,4059,97748670,6253,20240829,9-12,주간
12:00 ~ 14:59,1205,1205,9698,7534,502383600,17232,20240829,12-15,주간
15:00 ~ 17:59,1648,1648,9873,25529,2226147870,35402,20240829,15-18,주간
18:00 ~ 20:59,2469,2469,27497,29914,2843420177,57411,20240829,18-21,저녁
21:00 ~ 23:59,15,15,46,21,1243650,67,20240829,21-24,저녁
합계,5836,5836,49308,67057,5670943967,116365,20240829,,
00:00 ~ 2:59,0,0,0,0,0,0,20240830,0-3,심야
3:00 ~ 5:59,0,0,0,0,0,0,20240830,3-6,심야
6:00 ~ 8:59,1,1,0,2,36000,2,20240830,6-9,심야
9:00 ~ 11:59,498,498,1928,4135,85845320,6063,20240830,9-12,주간
12:00 ~ 14:59,1222,1222,21866,17010,1236567840,38876,20240830,12-15,주간
15:00 ~ 17:59,1683,1683,10732,15524,851327706,26256,20240830,15-18,주간
18:00 ~ 20:59,2420,2420,20828,24275,1688986150,45103,20240830,18-21,저녁
21:00 ~ 23:59,8,8,18,44,1263450,62,20240830,21-24,저녁
합계,5832,5832,55372,60990,3864026466,116362,20240830,,
00:00 ~ 2:59,0,0,0,0,0,0,20240831,0-3,심야
3:00 ~ 5:59,0,0,0,0,0,0,20240831,3-6,심야
6:00 ~ 8:59,1,1,0,2,36000,2,20240831,6-9,심야
9:00 ~ 11:59,495,495,974,3470,84699890,4444,20240831,9-12,주간
12:00 ~ 14:59,1208,1208,5988,7609,449106810,13597,20240831,12-15,주간
15:00 ~ 17:59,1614,1614,7540,12489,500757410,20029,20240831,15-18,주간
18:00 ~ 20:59,2123,2123,9737,12768,789022252,22505,20240831,18-21,저녁
21:00 ~ 23:59,3,3,11,-7,120000,4,20240831,21-24,저녁
합계,5444,5444,24250,36331,1823742362,60581,20240831,,
00:00 ~ 2:59,0,0,0,0,0,0,20240901,0-3,심야
3:00 ~ 5:59,0,0,0,0,0,0,20240901,3-6,심야
6:00 ~ 8:59,0,0,0,0,0,0,20240901,6-9,심야
9:00 ~ 11:59,440,440,1101,2284,102082030,3385,20240901,9-12,주간
12:00 ~ 14:59,1187,1187,5632,8420,412746480,14052,20240901,12-15,주간
15:00 ~ 17:59,1502,1502,5570,10107,397491835,15677,20240901,15-18,주간
18:00 ~ 20:59,2127,2127,10460,10030,591119870,20490,20240901,18-21,저녁
21:00 ~ 23:59,3,3,3,4,59000,7,20240901,21-24,저녁
합계,5259,5259,22766,30845,1503499215,53611,20240901,,
00:00 ~ 2:59,0,0,0,0,0,0,20240902,0-3,심야
3:00 ~ 5:59,0,0,0,0,0,0,20240902,3-6,심야
6:00 ~ 8:59,0,0,0,0,0,0,20240902,6-9,심야
9:00 ~ 11:59,462,462,1909,6253,583694390,8162,20240902,9-12,주간
12:00 ~ 14:59,1107,1107,4990,7270,373822702,12260,20240902,12-15,주간
15:00 ~ 17:59,1539,1539,7545,15866,1354467020,23411,20240902,15-18,주간
18:00 ~ 20:59,2336,2336,14585,22257,1441980170,36842,20240902,18-21,저녁
21:00 ~ 23:59,6,6,5,3,34000,8,20240902,21-24,저녁
합계,5450,5450,29034,51649,3753998282,80683,20240902,,
00:00 ~ 2:59,0,0,0,0,0,0,20240903,0-3,심야
3:00 ~ 5:59,0,0,0,0,0,0,20240903,3-6,심야
6:00 ~ 8:59,0,0,0,0,0,0,20240903,6-9,심야
9:00 ~ 11:59,451,451,2081,2174,117169720,4255,20240903,9-12,주간
12:00 ~ 14:59,1163,1163,8291,15411,1171338752,23702,20240903,12-15,주간
15:00 ~ 17:59,1590,1590,7831,15861,915932430,23692,20240903,15-18,주간
18:00 ~ 20:59,2480,2480,26226,53186,4157142030,79412,20240903,18-21,저녁
21:00 ~ 23:59,5,5,11,0,42000,11,20240903,21-24,저녁
합계,5689,5689,44440,86632,6361624932,131072,20240903,,
00:00 ~ 2:59,0,0,0,0,0,0,20240904,0-3,심야
3:00 ~ 5:59,0,0,0,0,0,0,20240904,3-6,심야
6:00 ~ 8:59,0,0,0,0,0,0,20240904,6-9,심야
9:00 ~ 11:59,463,463,1401,3414,106529870,4815,20240904,9-12,주간
12:00 ~ 14:59,1217,1217,7012,17565,1602750362,24577,20240904,12-15,주간
15:00 ~ 17:59,1661,1661,8242,14400,898871840,22642,20240904,15-18,주간
18:00 ~ 20:59,2607,2607,21567,35994,2817434630,57561,20240904,18-21,저녁
21:00 ~ 23:59,4,4,3,9,177000,12,20240904,21-24,저녁
합계,5952,5952,38225,71382,5425763702,109607,20240904,,
00:00 ~ 2:59,0,0,0,0,0,0,20240905,0-3,심야
3:00 ~ 5:59,0,0,0,0,0,0,20240905,3-6,심야
6:00 ~ 8:59,0,0,0,0,0,0,20240905,6-9,심야
9:00 ~ 11:59,484,484,1552,3337,94624240,4889,20240905,9-12,주간
12:00 ~ 14:59,1227,1227,7506,15454,939296630,22960,20240905,12-15,주간
15:00 ~ 17:59,1680,1680,8545,31052,3052456190,39597,20240905,15-18,주간
18:00 ~ 20:59,2503,2503,19022,42239,3615736820,61261,20240905,18-21,저녁
21:00 ~ 23:59,4,4,7,23,340500,30,20240905,21-24,저녁
합계,5898,5898,36632,92105,7702454380,128737,20240905,,
00:00 ~ 2:59,0,0,0,0,0,0,20240906,0-3,심야
3:00 ~ 5:59,0,0,0,0,0,0,20240906,3-6,심야
6:00 ~ 8:59,0,0,0,0,0,0,20240906,6-9,심야
9:00 ~ 11:59,526,526,1791,4396,116957810,6187,20240906,9-12,주간
12:00 ~ 14:59,1329,1329,7168,13076,603508600,20244,20240906,12-15,주간
15:00 ~ 17:59,1730,1730,9312,19930,1421401910,29242,20240906,15-18,주간
18:00 ~ 20:59,2474,2474,20058,51769,4524266430,71827,20240906,18-21,저녁
21:00 ~ 23:59,4,4,9,16,208950,25,20240906,21-24,저녁
합계,6063,6063,38338,89187,6666343700,127525,20240906,,
00:00 ~ 2:59,0,0,0,0,0,0,20240907,0-3,심야
3:00 ~ 5:59,0,0,0,0,0,0,20240907,3-6,심야
6:00 ~ 8:59,0,0,0,0,0,0,20240907,6-9,심야
9:00 ~ 11:59,468,468,1306,2223,92350745,3529,20240907,9-12,주간
12:00 ~ 14:59,1265,1265,5769,8020,450580138,13789,20240907,12-15,주간
15:00 ~ 17:59,1683,1683,8861,13320,699242700,22181,20240907,15-18,주간
18:00 ~ 20:59,2104,2104,11511,15923,1379262170,27434,20240907,18-21,저녁
21:00 ~ 23:59,3,3,2,4,77100,6,20240907,21-24,저녁
합계,5523,5523,27449,39490,2621512853,66939,20240907,,
00:00 ~ 2:59,0,0,0,0,0,0,20240908,0-3,심야
3:00 ~ 5:59,0,0,0,0,0,0,20240908,3-6,심야
6:00 ~ 8:59,0,0,0,0,0,0,20240908,6-9,심야
9:00 ~ 11:59,451,451,1050,1959,72181140,3009,20240908,9-12,주간
12:00 ~ 14:59,1171,1171,4379,6240,372271820,10619,20240908,12-15,주간
15:00 ~ 17:59,1532,1532,5870,9422,409388920,15292,20240908,15-18,주간
18:00 ~ 20:59,1981,1981,10876,9584,743193170,20460,20240908,18-21,저녁
21:00 ~ 23:59,4,4,3,3,111000,6,20240908,21-24,저녁
합계,5139,5139,22178,27208,1597146050,49386,20240908,,
00:00 ~ 2:59,0,0,0,0,0,0,20240909,0-3,심야
3:00 ~ 5:59,0,0,0,0,0,0,20240909,3-6,심야
6:00 ~ 8:59,0,0,0,0,0,0,20240909,6-9,심야
9:00 ~ 11:59,467,467,1386,3217,77964560,4603,20240909,9-12,주간
12:00 ~ 14:59,1176,1176,7198,15537,1182015110,22735,20240909,12-15,주간
15:00 ~ 17:59,1532,1532,7931,14462,747542140,22393,20240909,15-18,주간
18:00 ~ 20:59,2242,2242,17696,24679,1192189200,42375,20240909,18-21,저녁
21:00 ~ 23:59,4,4,2,18,356200,20,20240909,21-24,저녁
합계,5421,5421,34213,57913,3200067210,92126,20240909,,
00:00 ~ 2:59,0,0,0,0,0,0,20240910,0-3,심야
3:00 ~ 5:59,0,0,0,0,0,0,20240910,3-6,심야
6:00 ~ 8:59,0,0,0,0,0,0,20240910,6-9,심야
9:00 ~ 11:59,487,487,2193,2176,102651270,4369,20240910,9-12,주간
12:00 ~ 14:59,1199,1199,6086,10102,656107230,16188,20240910,12-15,주간
15:00 ~ 17:59,1617,1617,6788,15212,699174585,22000,20240910,15-18,주간
18:00 ~ 20:59,2425,2425,22378,34113,1868948135,56491,20240910,18-21,저녁
21:00 ~ 23:59,7,7,10,22,370900,32,20240910,21-24,저녁
합계,5735,5735,37455,61625,3327252120,99080,20240910,,
00:00 ~ 2:59,0,0,0,0,0,0,20240911,0-3,심야
3:00 ~ 5:59,0,0,0,0,0,0,20240911,3-6,심야
6:00 ~ 8:59,0,0,0,0,0,0,20240911,6-9,심야
9:00 ~ 11:59,461,461,1518,3663,85070780,5181,20240911,9-12,주간
12:00 ~ 14:59,1216,1216,6053,9928,685210550,15981,20240911,12-15,주간
15:00 ~ 17:59,1669,1669,9741,39303,4377545390,49044,20240911,15-18,주간
18:00 ~ 20:59,2385,2385,21972,54589,5423212695,76561,20240911,18-21,저녁
21:00 ~ 23:59,6,6,6,19,423100,25,20240911,21-24,저녁
합계,5737,5737,39290,107502,10571462515,146792,20240911,,
00:00 ~ 2:59,0,0,0,0,0,0,20240912,0-3,심야
3:00 ~ 5:59,0,0,0,0,0,0,20240912,3-6,심야
6:00 ~ 8:59,0,0,0,0,0,0,20240912,6-9,심야
9:00 ~ 11:59,474,474,1999,5556,120035440,7555,20240912,9-12,주간
12:00 ~ 14:59,1232,1232,7258,14762,918633826,22020,20240912,12-15,주간
15:00 ~ 17:59,1712,1712,9797,23468,1859388880,33265,20240912,15-18,주간
18:00 ~ 20:59,2363,2363,23970,46739,2897108350,70709,20240912,18-21,저녁
21:00 ~ 23:59,7,7,339,757,99313200,1096,20240912,21-24,저녁
합계,5788,5788,43363,91282,5894479696,134645,20240912,,
00:00 ~ 2:59,1,1,24,3,48000,27,20240913,0-3,심야
3:00 ~ 5:59,0,0,0,0,0,0,20240913,3-6,심야
6:00 ~ 8:59,1,1,2,-2,-36000,0,20240913,6-9,심야
9:00 ~ 11:59,473,473,1146,3535,86919660,4681,20240913,9-12,주간
12:00 ~ 14:59,1324,1324,7332,16578,1067192740,23910,20240913,12-15,주간
15:00 ~ 17:59,1843,1843,10682,21657,1405369240,32339,20240913,15-18,주간
18:00 ~ 20:59,2389,2389,27300,48387,3829190225,75687,20240913,18-21,저녁
21:00 ~ 23:59,5,5,432,1049,131638200,1481,20240913,21-24,저녁
합계,6036,6036,46918,91207,6520322065,138125,20240913,,
00:00 ~ 2:59,0,0,0,0,0,0,20240914,0-3,심야
3:00 ~ 5:59,0,0,0,0,0,0,20240914,3-6,심야
6:00 ~ 8:59,0,0,0,0,0,0,20240914,6-9,심야
9:00 ~ 11:59,469,469,1175,2171,107047950,3346,20240914,9-12,주간
12:00 ~ 14:59,1267,1267,6614,8379,523380200,14993,20240914,12-15,주간
15:00 ~ 17:59,1694,1694,7966,11353,593735490,19319,20240914,15-18,주간
18:00 ~ 20:59,2109,2109,15302,15909,1130323660,31211,20240914,18-21,저녁
21:00 ~ 23:59,3,3,86,72,8894000,158,20240914,21-24,저녁
합계,5542,5542,31143,37884,2363381300,69027,20240914,,
00:00 ~ 2:59,0,0,0,0,0,0,20240915,0-3,심야
3:00 ~ 5:59,0,0,0,0,0,0,20240915,3-6,심야
6:00 ~ 8:59,0,0,0,0,0,0,20240915,6-9,심야
9:00 ~ 11:59,380,380,873,1603,68162020,2476,20240915,9-12,주간
12:00 ~ 14:59,1098,1098,5606,7077,421050252,12683,20240915,12-15,주간
15:00 ~ 17:59,1462,1462,5511,7885,450946610,13396,20240915,15-18,주간
18:00 ~ 20:59,1934,1934,10516,10748,859674135,21264,20240915,18-21,저녁
21:00 ~ 23:59,2,2,59,6,-289000,65,20240915,21-24,저녁
합계,4876,4876,22565,27319,1799544017,49884,20240915,,
00:00 ~ 2:59,0,0,0,0,0,0,20240916,0-3,심야
3:00 ~ 5:59,0,0,0,0,0,0,20240916,3-6,심야
6:00 ~ 8:59,0,0,0,0,0,0,20240916,6-9,심야
9:00 ~ 11:59,353,353,561,1328,58242560,1889,20240916,9-12,주간
12:00 ~ 14:59,1007,1007,4670,5803,349241650,10473,20240916,12-15,주간
15:00 ~ 17:59,1311,1311,4414,5425,351386310,9839,20240916,15-18,주간
18:00 ~ 20:59,1828,1828,9060,8492,681572900,17552,20240916,18-21,저녁
21:00 ~ 23:59,3,3,22,46,5808000,68,20240916,21-24,저녁
합계,4502,4502,18727,21094,1446251420,39821,20240916,,
00:00 ~ 2:59,0,0,0,0,0,0,20240917,0-3,심야
3:00 ~ 5:59,0,0,0,0,0,0,20240917,3-6,심야
6:00 ~ 8:59,0,0,0,0,0,0,20240917,6-9,심야
9:00 ~ 11:59,364,364,634,1536,70787830,2170,20240917,9-12,주간
12:00 ~ 14:59,991,991,4025,5243,326339184,9268,20240917,12-15,주간
15:00 ~ 17:59,1334,1334,4388,6104,355464655,10492,20240917,15-18,주간
18:00 ~ 20:59,1793,1793,9344,7422,547340720,16766,20240917,18-21,저녁
21:00 ~ 23:59,4,4,30,32,3306100,62,20240917,21-24,저녁
합계,4486,4486,18421,20337,1303238489,38758,20240917,,
00:00 ~ 2:59,0,0,0,0,0,0,20240918,0-3,심야
3:00 ~ 5:59,0,0,0,0,0,0,20240918,3-6,심야
6:00 ~ 8:59,0,0,0,0,0,0,20240918,6-9,심야
9:00 ~ 11:59,401,401,851,1681,67038820,2532,20240918,9-12,주간
12:00 ~ 14:59,1098,1098,4999,5092,265957580,10091,20240918,12-15,주간
15:00 ~ 17:59,1486,1486,5072,5650,267682195,10722,20240918,15-18,주간
18:00 ~ 20:59,1981,1981,11739,8537,441007220,20276,20240918,18-21,저녁
21:00 ~ 23:59,4,4,37,38,4927100,75,20240918,21-24,저녁
합계,4970,4970,22698,20998,1046612915,43696,20240918,,
00:00 ~ 2:59,0,0,0,0,0,0,20240919,0-3,심야
3:00 ~ 5:59,0,0,0,0,0,0,20240919,3-6,심야
6:00 ~ 8:59,0,0,0,0,0,0,20240919,6-9,심야
9:00 ~ 11:59,537,537,1541,3714,91646540,5255,20240919,9-12,주간
12:00 ~ 14:59,1202,1202,6011,7756,375518634,13767,20240919,12-15,주간
15:00 ~ 17:59,1757,1757,8662,21452,1815087970,30114,20240919,15-18,주간
18:00 ~ 20:59,2475,2475,22180,36189,3023385630,58369,20240919,18-21,저녁
21:00 ~ 23:59,4,4,88,98,5779600,186,20240919,21-24,저녁
합계,5975,5975,38482,69209,5311418374,107691,20240919,,
00:00 ~ 2:59,0,0,0,0,0,0,20240920,0-3,심야
3:00 ~ 5:59,0,0,0,0,0,0,20240920,3-6,심야
6:00 ~ 8:59,0,0,0,0,0,0,20240920,6-9,심야
9:00 ~ 11:59,565,565,1779,5198,101589820,6977,20240920,9-12,주간
12:00 ~ 14:59,1290,1290,7319,10669,485617680,17988,20240920,12-15,주간
15:00 ~ 17:59,1821,1821,9889,17856,1381011320,27745,20240920,15-18,주간
18:00 ~ 20:59,2523,2523,27342,52171,5295029005,79513,20240920,18-21,저녁
21:00 ~ 23:59,8,8,41,145,8133650,186,20240920,21-24,저녁
합계,6207,6207,46370,86039,7271381475,132409,20240920,,
00:00 ~ 2:59,0,0,0,0,0,0,20240921,0-3,심야
3:00 ~ 5:59,0,0,0,0,0,0,20240921,3-6,심야
6:00 ~ 8:59,0,0,0,0,0,0,20240921,6-9,심야
9:00 ~ 11:59,516,516,1448,3158,91959075,4606,20240921,9-12,주간
12:00 ~ 14:59,1218,1218,5118,6309,328371928,11427,20240921,12-15,주간
15:00 ~ 17:59,1642,1642,7659,12013,746860700,19672,20240921,15-18,주간
18:00 ~ 20:59,2141,2141,17264,16258,1240560920,33522,20240921,18-21,저녁
21:00 ~ 23:59,8,8,24,46,2761200,70,20240921,21-24,저녁
합계,5525,5525,31513,37784,2410513823,69297,20240921,,
00:00 ~ 2:59,0,0,0,0,0,0,20240922,0-3,심야
3:00 ~ 5:59,0,0,0,0,0,0,20240922,3-6,심야
6:00 ~ 8:59,0,0,0,0,0,0,20240922,6-9,심야
9:00 ~ 11:59,434,434,1043,1945,66035020,2988,20240922,9-12,주간
12:00 ~ 14:59,1157,1157,4546,5563,277909911,10109,20240922,12-15,주간
15:00 ~ 17:59,1536,1536,4851,9699,520783370,14550,20240922,15-18,주간
18:00 ~ 20:59,2047,2047,11842,10479,762469995,22321,20240922,18-21,저녁
21:00 ~ 23:59,5,5,17,31,3416000,48,20240922,21-24,저녁
합계,5179,5179,22299,27717,1630614296,50016,20240922,,
00:00 ~ 2:59,1,1,3,-3,-48000,0,20240923,0-3,심야
3:00 ~ 5:59,0,0,0,0,0,0,20240923,3-6,심야
6:00 ~ 8:59,0,0,0,0,0,0,20240923,6-9,심야
9:00 ~ 11:59,472,472,1820,2099,69388260,3919,20240923,9-12,주간
12:00 ~ 14:59,1095,1095,4203,6531,278550200,10734,20240923,12-15,주간
15:00 ~ 17:59,1628,1628,14288,28681,1033480300,42969,20240923,15-18,주간
18:00 ~ 20:59,2345,2345,20077,39122,2894779805,59199,20240923,18-21,저녁
21:00 ~ 23:59,8,8,31,58,4029400,89,20240923,21-24,저녁
합계,5549,5549,40422,76488,4280179965,116910,20240923,,
00:00 ~ 2:59,0,0,0,0,0,0,20240924,0-3,심야
3:00 ~ 5:59,0,0,0,0,0,0,20240924,3-6,심야
6:00 ~ 8:59,0,0,0,0,0,0,20240924,6-9,심야
9:00 ~ 11:59,523,523,2715,4278,85040580,6993,20240924,9-12,주간
12:00 ~ 14:59,1200,1200,7745,15849,1019021292,23594,20240924,12-15,주간
15:00 ~ 17:59,1766,1766,12185,23305,1386636160,35490,20240924,15-18,주간
18:00 ~ 20:59,2601,2601,46046,186704,25783161500,232750,20240924,18-21,저녁
21:00 ~ 23:59,11,11,45,71,6494200,116,20240924,21-24,저녁
합계,6101,6101,68736,230207,28280353732,298943,20240924,,
00:00 ~ 2:59,0,0,0,0,0,0,20240925,0-3,심야
3:00 ~ 5:59,0,0,0,0,0,0,20240925,3-6,심야
6:00 ~ 8:59,0,0,0,0,0,0,20240925,6-9,심야
9:00 ~ 11:59,521,521,2977,3867,106690930,6844,20240925,9-12,주간
12:00 ~ 14:59,1228,1228,5782,12064,847236634,17846,20240925,12-15,주간
15:00 ~ 17:59,1777,1777,23209,12864,1122240340,36073,20240925,15-18,주간
18:00 ~ 20:59,2625,2625,42198,101367,11826691020,143565,20240925,18-21,저녁
21:00 ~ 23:59,11,11,43,86,7609300,129,20240925,21-24,저녁
합계,6162,6162,74209,130248,13910468224,204457,20240925,,
00:00 ~ 2:59,0,0,0,0,0,0,20240926,0-3,심야
3:00 ~ 5:59,0,0,0,0,0,0,20240926,3-6,심야
6:00 ~ 8:59,0,0,0,0,0,0,20240926,6-9,심야
9:00 ~ 11:59,521,521,1689,4783,74314020,6472,20240926,9-12,주간
12:00 ~ 14:59,1301,1301,6342,11575,722028951,17917,20240926,12-15,주간
15:00 ~ 17:59,1827,1827,10385,14768,799335840,25153,20240926,15-18,주간
18:00 ~ 20:59,2663,2663,27130,45140,3329324842,72270,20240926,18-21,저녁
21:00 ~ 23:59,9,9,20,48,3863000,68,20240926,21-24,저녁
합계,6321,6321,45566,76314,4928866653,121880,20240926,,
00:00 ~ 2:59,0,0,0,0,0,0,20240927,0-3,심야
3:00 ~ 5:59,0,0,0,0,0,0,20240927,3-6,심야
6:00 ~ 8:59,0,0,0,0,0,0,20240927,6-9,심야
9:00 ~ 11:59,513,513,1942,5335,121737840,7277,20240927,9-12,주간
12:00 ~ 14:59,1352,1352,7506,13504,607604234,21010,20240927,12-15,주간
15:00 ~ 17:59,1929,1929,13659,27832,1932542120,41491,20240927,15-18,주간
18:00 ~ 20:59,2680,2680,52757,123623,14939529690,176380,20240927,18-21,저녁
21:00 ~ 23:59,7,7,35,78,5456300,113,20240927,21-24,저녁
합계,6481,6481,75899,170372,17606870184,246271,20240927,,
00:00 ~ 2:59,0,0,0,0,0,0,20240928,0-3,심야
3:00 ~ 5:59,0,0,0,0,0,0,20240928,3-6,심야
6:00 ~ 8:59,0,0,0,0,0,0,20240928,6-9,심야
9:00 ~ 11:59,484,484,1555,2383,87974430,3938,20240928,9-12,주간
12:00 ~ 14:59,1279,1279,6731,6157,377261490,12888,20240928,12-15,주간
15:00 ~ 17:59,1782,1782,9159,12980,507193532,22139,20240928,15-18,주간
18:00 ~ 20:59,2306,2306,17362,17433,1125722985,34795,20240928,18-21,저녁
21:00 ~ 23:59,5,5,28,43,4391000,71,20240928,21-24,저녁
합계,5856,5856,34835,38996,2102543437,73831,20240928,,
00:00 ~ 2:59,0,0,0,0,0,0,20240929,0-3,심야
3:00 ~ 5:59,0,0,0,0,0,0,20240929,3-6,심야
6:00 ~ 8:59,0,0,0,0,0,0,20240929,6-9,심야
9:00 ~ 11:59,437,437,1197,1705,71054970,2902,20240929,9-12,주간
12:00 ~ 14:59,1252,1252,4661,6657,302200122,11318,20240929,12-15,주간
15:00 ~ 17:59,1683,1683,6762,9632,429449785,16394,20240929,15-18,주간
18:00 ~ 20:59,2274,2274,15264,12388,746022830,27652,20240929,18-21,저녁
21:00 ~ 23:59,6,6,15,45,4013000,60,20240929,21-24,저녁
합계,5652,5652,27899,30427,1552740707,58326,20240929,,
00:00 ~ 2:59,0,0,0,0,0,0,20240930,0-3,심야
3:00 ~ 5:59,0,0,0,0,0,0,20240930,3-6,심야
6:00 ~ 8:59,0,0,0,0,0,0,20240930,6-9,심야
9:00 ~ 11:59,486,486,1347,2604,83804650,3951,20240930,9-12,주간
12:00 ~ 14:59,1306,1306,6479,18528,1244992675,25007,20240930,12-15,주간
15:00 ~ 17:59,1825,1825,9220,32422,1857306600,41642,20240930,15-18,주간
18:00 ~ 20:59,2646,2646,61098,101357,13224766240,162455,20240930,18-21,저녁
21:00 ~ 23:59,8,8,28,27,1931200,55,20240930,21-24,저녁
합계,6271,6271,78172,154938,16412801365,233110,20240930,,
00:00 ~ 2:59,0,0,0,0,0,0,20241001,0-3,심야
3:00 ~ 5:59,0,0,0,0,0,0,20241001,3-6,심야
6:00 ~ 8:59,0,0,0,0,0,0,20241001,6-9,심야
9:00 ~ 11:59,519,519,1372,2581,89398270,3953,20241001,9-12,주간
12:00 ~ 14:59,1316,1316,5153,8298,473673780,13451,20241001,12-15,주간
15:00 ~ 17:59,1843,1843,8066,19348,935486605,27414,20241001,15-18,주간
18:00 ~ 20:59,2584,2584,34142,19255,1415191437,53397,20241001,18-21,저녁
21:00 ~ 23:59,11,11,32,52,5201750,84,20241001,21-24,저녁
합계,6273,6273,48765,49534,2918951842,98299,20241001,,
00:00 ~ 2:59,0,0,0,0,0,0,20241002,0-3,심야
3:00 ~ 5:59,0,0,0,0,0,0,20241002,3-6,심야
6:00 ~ 8:59,0,0,0,0,0,0,20241002,6-9,심야
9:00 ~ 11:59,536,536,1588,6149,99337400,7737,20241002,9-12,주간
12:00 ~ 14:59,1301,1301,7580,17644,1407112172,25224,20241002,12-15,주간
15:00 ~ 17:59,1879,1879,17867,32332,2872596170,50199,20241002,15-18,주간
18:00 ~ 20:59,2770,2770,35408,43035,3215867978,78443,20241002,18-21,저녁
21:00 ~ 23:59,10,10,33,27,2036750,60,20241002,21-24,저녁
합계,6496,6496,62476,99187,7596950470,161663,20241002,,
00:00 ~ 2:59,0,0,0,0,0,0,20241003,0-3,심야
3:00 ~ 5:59,0,0,0,0,0,0,20241003,3-6,심야
6:00 ~ 8:59,0,0,0,0,0,0,20241003,6-9,심야
9:00 ~ 11:59,485,485,1291,2821,102063190,4112,20241003,9-12,주간
12:00 ~ 14:59,1296,1296,5380,7267,397698552,12647,20241003,12-15,주간
15:00 ~ 17:59,1762,1762,9529,11326,435936600,20855,20241003,15-18,주간
18:00 ~ 20:59,2438,2438,22213,17930,1300851700,40143,20241003,18-21,저녁
21:00 ~ 23:59,10,10,27,41,2818000,68,20241003,21-24,저녁
합계,5991,5991,38440,39385,2239368042,77825,20241003,,
00:00 ~ 2:59,0,0,0,0,0,0,20241004,0-3,심야
3:00 ~ 5:59,0,0,0,0,0,0,20241004,3-6,심야
6:00 ~ 8:59,0,0,0,0,0,0,20241004,6-9,심야
9:00 ~ 11:59,568,568,2263,9732,127810200,11995,20241004,9-12,주간
12:00 ~ 14:59,1313,1313,11993,15079,533347940,27072,20241004,12-15,주간
15:00 ~ 17:59,1899,1899,15074,33094,1836432780,48168,20241004,15-18,주간
18:00 ~ 20:59,2714,2714,33689,47833,2523738425,81522,20241004,18-21,저녁
21:00 ~ 23:59,5,5,24,32,1962100,56,20241004,21-24,저녁
합계,6499,6499,63043,105770,5023291445,168813,20241004,,
00:00 ~ 2:59,0,0,0,0,0,0,20241005,0-3,심야
3:00 ~ 5:59,0,0,0,0,0,0,20241005,3-6,심야
6:00 ~ 8:59,0,0,0,0,0,0,20241005,6-9,심야
9:00 ~ 11:59,470,470,1178,2065,56324760,3243,20241005,9-12,주간
12:00 ~ 14:59,1224,1224,6342,5858,302347766,12200,20241005,12-15,주간
15:00 ~ 17:59,1720,1720,9214,13322,780593190,22536,20241005,15-18,주간
18:00 ~ 20:59,2365,2365,15545,16622,1120921705,32167,20241005,18-21,저녁
21:00 ~ 23:59,5,5,20,23,2543100,43,20241005,21-24,저녁
합계,5784,5784,32299,37890,2262730521,70189,20241005,,
00:00 ~ 2:59,0,0,0,0,0,0,20241006,0-3,심야
3:00 ~ 5:59,0,0,0,0,0,0,20241006,3-6,심야
6:00 ~ 8:59,0,0,0,0,0,0,20241006,6-9,심야
9:00 ~ 11:59,442,442,1091,1866,55747040,2957,20241006,9-12,주간
12:00 ~ 14:59,1143,1143,5819,4982,300569230,10801,20241006,12-15,주간
15:00 ~ 17:59,1590,1590,7583,8189,509923830,15772,20241006,15-18,주간
18:00 ~ 20:59,2287,2287,14160,11622,783670000,25782,20241006,18-21,저녁
21:00 ~ 23:59,7,7,20,53,5220100,73,20241006,21-24,저녁
합계,5469,5469,28673,26712,1655130200,55385,20241006,,
00:00 ~ 2:59,0,0,0,0,0,0,20241007,0-3,심야
3:00 ~ 5:59,0,0,0,0,0,0,20241007,3-6,심야
6:00 ~ 8:59,0,0,0,0,0,0,20241007,6-9,심야
9:00 ~ 11:59,497,497,1029,3035,65129140,4064,20241007,9-12,주간
12:00 ~ 14:59,1129,1129,4324,8378,347803460,12702,20241007,12-15,주간
15:00 ~ 17:59,1713,1713,9013,16613,961716540,25626,20241007,15-18,주간
18:00 ~ 20:59,2541,2541,25519,41007,3007494897,66526,20241007,18-21,저녁
21:00 ~ 23:59,9,9,29,55,4396200,84,20241007,21-24,저녁
합계,5889,5889,39914,69088,4386540237,109002,20241007,,
00:00 ~ 2:59,0,0,0,0,0,0,20241008,0-3,심야
3:00 ~ 5:59,0,0,0,0,0,0,20241008,3-6,심야
6:00 ~ 8:59,0,0,0,0,0,0,20241008,6-9,심야
9:00 ~ 11:59,503,503,1195,3505,73650170,4700,20241008,9-12,주간
12:00 ~ 14:59,1214,1214,6074,15651,620144750,21725,20241008,12-15,주간
15:00 ~ 17:59,1741,1741,12742,37823,3299871190,50565,20241008,15-18,주간
18:00 ~ 20:59,2698,2698,24224,48607,3600633512,72831,20241008,18-21,저녁
21:00 ~ 23:59,8,8,14,90,6452100,104,20241008,21-24,저녁
합계,6164,6164,44249,105676,7600751722,149925,20241008,,
00:00 ~ 2:59,0,0,0,0,0,0,20241009,0-3,심야
3:00 ~ 5:59,0,0,0,0,0,0,20241009,3-6,심야
6:00 ~ 8:59,0,0,0,0,0,0,20241009,6-9,심야
9:00 ~ 11:59,466,466,1191,1779,52735530,2970,20241009,9-12,주간
12:00 ~ 14:59,1188,1188,5454,6030,321132030,11484,20241009,12-15,주간
15:00 ~ 17:59,1707,1707,7704,13079,824143462,20783,20241009,15-18,주간
18:00 ~ 20:59,2472,2472,15391,20612,1097569270,36003,20241009,18-21,저녁
21:00 ~ 23:59,7,7,26,13,1524000,39,20241009,21-24,저녁
합계,5840,5840,29766,41513,2297104292,71279,20241009,,
00:00 ~ 2:59,0,0,0,0,0,0,20241010,0-3,심야
3:00 ~ 5:59,0,0,0,0,0,0,20241010,3-6,심야
6:00 ~ 8:59,0,0,0,0,0,0,20241010,6-9,심야
9:00 ~ 11:59,562,562,2738,9274,77414590,12012,20241010,9-12,주간
12:00 ~ 14:59,1189,1189,6309,19389,972992030,25698,20241010,12-15,주간
15:00 ~ 17:59,1823,1823,15301,35868,2353030150,51169,20241010,15-18,주간
18:00 ~ 20:59,2795,2795,26988,61921,4274292775,88909,20241010,18-21,저녁
21:00 ~ 23:59,11,11,22,22,2129200,44,20241010,21-24,저녁
합계,6380,6380,51358,126474,7679858745,177832,20241010,,
00:00 ~ 2:59,0,0,0,0,0,0,20241011,0-3,심야
3:00 ~ 5:59,0,0,0,0,0,0,20241011,3-6,심야
6:00 ~ 8:59,0,0,0,0,0,0,20241011,6-9,심야
9:00 ~ 11:59,484,484,1660,4720,126635950,6380,20241011,9-12,주간
12:00 ~ 14:59,1147,1147,6225,11041,608070350,17266,20241011,12-15,주간
15:00 ~ 17:59,1789,1789,13457,20926,875480500,34383,20241011,15-18,주간
18:00 ~ 20:59,2785,2785,26681,36863,2287719280,63544,20241011,18-21,저녁
21:00 ~ 23:59,9,9,12,63,3497200,75,20241011,21-24,저녁
합계,6214,6214,48035,73613,3901403280,121648,20241011,,
00:00 ~ 2:59,0,0,0,0,0,0,20241012,0-3,심야
3:00 ~ 5:59,0,0,0,0,0,0,20241012,3-6,심야
6:00 ~ 8:59,0,0,0,0,0,0,20241012,6-9,심야
9:00 ~ 11:59,446,446,1439,3419,70193800,4858,20241012,9-12,주간
12:00 ~ 14:59,1125,1125,5657,7021,394110538,12678,20241012,12-15,주간
15:00 ~ 17:59,1638,1638,13382,11297,528376350,24679,20241012,15-18,주간
18:00 ~ 20:59,2437,2437,16720,14977,1030882629,31697,20241012,18-21,저녁
21:00 ~ 23:59,6,6,16,17,711100,33,20241012,21-24,저녁
합계,5652,5652,37214,36731,2024274417,73945,20241012,,
00:00 ~ 2:59,0,0,0,0,0,0,20241013,0-3,심야
3:00 ~ 5:59,0,0,0,0,0,0,20241013,3-6,심야
6:00 ~ 8:59,0,0,0,0,0,0,20241013,6-9,심야
9:00 ~ 11:59,417,417,1014,1461,42693930,2475,20241013,9-12,주간
12:00 ~ 14:59,1008,1008,4304,5750,296523020,10054,20241013,12-15,주간
15:00 ~ 17:59,1516,1516,6843,9445,477987890,16288,20241013,15-18,주간
18:00 ~ 20:59,2278,2278,11260,10398,729502660,21658,20241013,18-21,저녁
21:00 ~ 23:59,5,5,13,11,875000,24,20241013,21-24,저녁
합계,5224,5224,23434,27065,1547582500,50499,20241013,,
00:00 ~ 2:59,0,0,0,0,0,0,20241014,0-3,심야
3:00 ~ 5:59,0,0,0,0,0,0,20241014,3-6,심야
6:00 ~ 8:59,0,0,0,0,0,0,20241014,6-9,심야
9:00 ~ 11:59,458,458,1714,2110,43318110,3824,20241014,9-12,주간
12:00 ~ 14:59,1041,1041,5656,8216,369450130,13872,20241014,12-15,주간
15:00 ~ 17:59,1595,1595,10062,17761,962729070,27823,20241014,15-18,주간
18:00 ~ 20:59,2620,2620,21763,47135,3720128469,68898,20241014,18-21,저녁
21:00 ~ 23:59,9,9,18,38,4467000,56,20241014,21-24,저녁
합계,5723,5723,39213,75260,5100092779,114473,20241014,,
00:00 ~ 2:59,0,0,0,0,0,0,20241015,0-3,심야
3:00 ~ 5:59,0,0,0,0,0,0,20241015,3-6,심야
6:00 ~ 8:59,0,0,0,0,0,0,20241015,6-9,심야
9:00 ~ 11:59,471,471,1240,3901,58577720,5141,20241015,9-12,주간
12:00 ~ 14:59,1069,1069,5741,8952,466368520,14693,20241015,12-15,주간
15:00 ~ 17:59,1685,1685,12293,41701,5108582500,53994,20241015,15-18,주간
18:00 ~ 20:59,2763,2763,34866,104821,11393486250,139687,20241015,18-21,저녁
21:00 ~ 23:59,10,10,30,36,3481200,66,20241015,21-24,저녁
합계,5998,5998,54170,159411,17030496190,213581,20241015,,
00:00 ~ 2:59,0,0,0,0,0,0,20241016,0-3,심야
3:00 ~ 5:59,0,0,0,0,0,0,20241016,3-6,심야
6:00 ~ 8:59,0,0,0,0,0,0,20241016,6-9,심야
9:00 ~ 11:59,500,500,1546,3356,62308090,4902,20241016,9-12,주간
12:00 ~ 14:59,1109,1109,11850,14637,1316541160,26487,20241016,12-15,주간
15:00 ~ 17:59,1785,1785,11504,19494,1535442760,30998,20241016,15-18,주간
18:00 ~ 20:59,2800,2800,40399,60724,5882112790,101123,20241016,18-21,저녁
21:00 ~ 23:59,10,10,27,21,467200,48,20241016,21-24,저녁
합계,6204,6204,65326,98232,8796872000,163558,20241016,,
00:00 ~ 2:59,0,0,0,0,0,0,20241017,0-3,심야
3:00 ~ 5:59,0,0,0,0,0,0,20241017,3-6,심야
6:00 ~ 8:59,0,0,0,0,0,0,20241017,6-9,심야
9:00 ~ 11:59,538,538,1928,3388,73015880,5316,20241017,9-12,주간
12:00 ~ 14:59,1200,1200,6712,11510,787800010,18222,20241017,12-15,주간
15:00 ~ 17:59,1744,1744,9610,21196,1406162710,30806,20241017,15-18,주간
18:00 ~ 20:59,2904,2904,26468,48725,3762856130,75193,20241017,18-21,저녁
21:00 ~ 23:59,9,9,15,44,4509900,59,20241017,21-24,저녁
합계,6395,6395,44733,84863,6034344630,129596,20241017,,
00:00 ~ 2:59,0,0,0,0,0,0,20241018,0-3,심야
3:00 ~ 5:59,0,0,0,0,0,0,20241018,3-6,심야
6:00 ~ 8:59,0,0,0,0,0,0,20241018,6-9,심야
9:00 ~ 11:59,513,513,1883,3865,71298620,5748,20241018,9-12,주간
12:00 ~ 14:59,1248,1248,5934,11523,522060860,17457,20241018,12-15,주간
15:00 ~ 17:59,1833,1833,10409,18431,799664870,28840,20241018,15-18,주간
18:00 ~ 20:59,2865,2865,22082,35357,1756927620,57439,20241018,18-21,저녁
21:00 ~ 23:59,9,9,18,46,2495550,64,20241018,21-24,저녁
합계,6468,6468,40326,69222,3152447520,109548,20241018,,
00:00 ~ 2:59,0,0,0,0,0,0,20241019,0-3,심야
3:00 ~ 5:59,0,0,0,0,0,0,20241019,3-6,심야
6:00 ~ 8:59,0,0,0,0,0,0,20241019,6-9,심야
9:00 ~ 11:59,484,484,857,3421,48928200,4278,20241019,9-12,주간
12:00 ~ 14:59,1162,1162,6212,6406,374763370,12618,20241019,12-15,주간
15:00 ~ 17:59,1650,1650,7518,13617,583864240,21135,20241019,15-18,주간
18:00 ~ 20:59,2418,2418,15911,15791,954662300,31702,20241019,18-21,저녁
21:00 ~ 23:59,6,6,9,16,1555000,25,20241019,21-24,저녁
합계,5720,5720,30507,39251,1963773110,69758,20241019,,
00:00 ~ 2:59,0,0,0,0,0,0,20241020,0-3,심야
3:00 ~ 5:59,0,0,0,0,0,0,20241020,3-6,심야
6:00 ~ 8:59,0,0,0,0,0,0,20241020,6-9,심야
9:00 ~ 11:59,443,443,763,1733,42502240,2496,20241020,9-12,주간
12:00 ~ 14:59,1078,1078,5139,5314,297046000,10453,20241020,12-15,주간
15:00 ~ 17:59,1506,1506,5668,9704,508882870,15372,20241020,15-18,주간
18:00 ~ 20:59,2328,2328,12009,11406,734654570,23415,20241020,18-21,저녁
21:00 ~ 23:59,6,6,7,42,3515000,49,20241020,21-24,저녁
합계,5361,5361,23586,28199,1586600680,51785,20241020,,
00:00 ~ 2:59,0,0,0,0,0,0,20241021,0-3,심야
3:00 ~ 5:59,0,0,0,0,0,0,20241021,3-6,심야
6:00 ~ 8:59,0,0,0,0,0,0,20241021,6-9,심야
9:00 ~ 11:59,487,487,960,4597,60465180,5557,20241021,9-12,주간
12:00 ~ 14:59,1064,1064,4295,6554,336373000,10849,20241021,12-15,주간
15:00 ~ 17:59,1620,1620,10314,11110,746080230,21424,20241021,15-18,주간
18:00 ~ 20:59,2611,2611,18792,25703,1332739200,44495,20241021,18-21,저녁
21:00 ~ 23:59,6,6,21,26,1963000,47,20241021,21-24,저녁
합계,5788,5788,34382,47990,2477620610,82372,20241021,,
00:00 ~ 2:59,0,0,0,0,0,0,20241022,0-3,심야
3:00 ~ 5:59,0,0,0,0,0,0,20241022,3-6,심야
6:00 ~ 8:59,1,1,0,30,0,30,20241022,6-9,심야
9:00 ~ 11:59,457,457,1272,5141,58419650,6413,20241022,9-12,주간
12:00 ~ 14:59,1042,1042,5458,9263,662937520,14721,20241022,12-15,주간
15:00 ~ 17:59,1622,1622,8109,14837,887575080,22946,20241022,15-18,주간
18:00 ~ 20:59,2786,2786,24378,44334,2059427300,68712,20241022,18-21,저녁
21:00 ~ 23:59,12,12,26,78,3084850,104,20241022,21-24,저녁
합계,5920,5920,39243,73683,3671444400,112926,20241022,,
00:00 ~ 2:59,0,0,0,0,0,0,20241023,0-3,심야
3:00 ~ 5:59,0,0,0,0,0,0,20241023,3-6,심야
6:00 ~ 8:59,1,1,0,9,0,9,20241023,6-9,심야
9:00 ~ 11:59,495,495,1267,3583,67220820,4850,20241023,9-12,주간
12:00 ~ 14:59,1098,1098,5696,7429,375301054,13125,20241023,12-15,주간
15:00 ~ 17:59,1729,1729,8793,16915,1255374850,25708,20241023,15-18,주간
18:00 ~ 20:59,2766,2766,22196,35852,2725365720,58048,20241023,18-21,저녁
21:00 ~ 23:59,11,11,362,1642,245147700,2004,20241023,21-24,저녁
합계,6100,6100,38314,65430,4668410144,103744,20241023,,
00:00 ~ 2:59,0,0,0,0,0,0,20241024,0-3,심야
3:00 ~ 5:59,0,0,0,0,0,0,20241024,3-6,심야
6:00 ~ 8:59,1,1,0,11,0,11,20241024,6-9,심야
9:00 ~ 11:59,535,535,2481,5337,98201840,7818,20241024,9-12,주간
12:00 ~ 14:59,1176,1176,8893,15626,1154668190,24519,20241024,12-15,주간
15:00 ~ 17:59,1788,1788,9940,27927,2135847490,37867,20241024,15-18,주간
18:00 ~ 20:59,2848,2848,27589,54820,4313683634,82409,20241024,18-21,저녁
21:00 ~ 23:59,11,11,118,115,13746000,233,20241024,21-24,저녁
합계,6359,6359,49021,103836,7716147154,152857,20241024,,
00:00 ~ 2:59,0,0,0,0,0,0,20241025,0-3,심야
3:00 ~ 5:59,1,1,0,2,24000,2,20241025,3-6,심야
6:00 ~ 8:59,0,0,0,0,0,0,20241025,6-9,심야
9:00 ~ 11:59,526,526,1612,5351,71479350,6963,20241025,9-12,주간
12:00 ~ 14:59,1263,1263,5579,13343,570549570,18922,20241025,12-15,주간
15:00 ~ 17:59,1858,1858,11642,20941,1265718000,32583,20241025,15-18,주간
18:00 ~ 20:59,2845,2845,23155,37612,2024241760,60767,20241025,18-21,저녁
21:00 ~ 23:59,9,9,33,75,7663000,108,20241025,21-24,저녁
합계,6502,6502,42021,77324,3939675680,119345,20241025,,
00:00 ~ 2:59,0,0,0,0,0,0,20241026,0-3,심야
3:00 ~ 5:59,0,0,0,0,0,0,20241026,3-6,심야
6:00 ~ 8:59,0,0,0,0,0,0,20241026,6-9,심야
9:00 ~ 11:59,470,470,891,2635,54753970,3526,20241026,9-12,주간
12:00 ~ 14:59,1207,1207,5858,7630,395664810,13488,20241026,12-15,주간
15:00 ~ 17:59,1738,1738,8421,17444,816934980,25865,20241026,15-18,주간
18:00 ~ 20:59,2462,2462,12923,15569,1088734460,28492,20241026,18-21,저녁
21:00 ~ 23:59,9,9,28,55,5481000,83,20241026,21-24,저녁
합계,5886,5886,28121,43333,2361569220,71454,20241026,,
00:00 ~ 2:59,0,0,0,0,0,0,20241027,0-3,심야
3:00 ~ 5:59,0,0,0,0,0,0,20241027,3-6,심야
6:00 ~ 8:59,0,0,0,0,0,0,20241027,6-9,심야
9:00 ~ 11:59,455,455,684,2139,51534370,2823,20241027,9-12,주간
12:00 ~ 14:59,1132,1132,4922,6525,313614640,11447,20241027,12-15,주간
15:00 ~ 17:59,1582,1582,6423,10448,634068630,16871,20241027,15-18,주간
18:00 ~ 20:59,2388,2388,10810,11512,849958010,22322,20241027,18-21,저녁
21:00 ~ 23:59,12,12,48,41,2755600,89,20241027,21-24,저녁
합계,5569,5569,22887,30665,1851931250,53552,20241027,,
00:00 ~ 2:59,0,0,0,0,0,0,20241028,0-3,심야
3:00 ~ 5:59,0,0,0,0,0,0,20241028,3-6,심야
6:00 ~ 8:59,0,0,0,0,0,0,20241028,6-9,심야
9:00 ~ 11:59,471,471,1316,2922,52492770,4238,20241028,9-12,주간
12:00 ~ 14:59,1171,1171,4607,10632,338359912,15239,20241028,12-15,주간
15:00 ~ 17:59,1742,1742,8556,22556,1523919670,31112,20241028,15-18,주간
18:00 ~ 20:59,2669,2669,30037,91177,10913670180,121214,20241028,18-21,저녁
21:00 ~ 23:59,11,11,1059,11572,1578929400,12631,20241028,21-24,저녁
합계,6064,6064,45575,138859,14407371932,184434,20241028,,
00:00 ~ 2:59,0,0,0,0,0,0,20241029,0-3,심야
3:00 ~ 5:59,0,0,0,0,0,0,20241029,3-6,심야
6:00 ~ 8:59,0,0,0,0,0,0,20241029,6-9,심야
9:00 ~ 11:59,505,505,1389,3189,69224630,4578,20241029,9-12,주간
12:00 ~ 14:59,1163,1163,4847,6698,331506300,11545,20241029,12-15,주간
15:00 ~ 17:59,1770,1770,10170,30867,2916738180,41037,20241029,15-18,주간
18:00 ~ 20:59,2772,2772,29745,51761,5329376810,81506,20241029,18-21,저녁
21:00 ~ 23:59,11,11,412,46,3682750,458,20241029,21-24,저녁
합계,6221,6221,46563,92561,8650528670,139124,20241029,,
00:00 ~ 2:59,0,0,0,0,0,0,20241030,0-3,심야
3:00 ~ 5:59,0,0,0,0,0,0,20241030,3-6,심야
6:00 ~ 8:59,0,0,0,0,0,0,20241030,6-9,심야
9:00 ~ 11:59,549,549,1618,4167,63289530,5785,20241030,9-12,주간
12:00 ~ 14:59,1225,1225,5733,8508,354053880,14241,20241030,12-15,주간
15:00 ~ 17:59,1836,1836,10089,18838,1460061870,28927,20241030,15-18,주간
18:00 ~ 20:59,2811,2811,29861,41756,3706623760,71617,20241030,18-21,저녁
21:00 ~ 23:59,13,13,267,34,97050,301,20241030,21-24,저녁
합계,6434,6434,47568,73303,5584126090,120871,20241030,,
00:00 ~ 2:59,0,0,0,0,0,0,20241031,0-3,심야
3:00 ~ 5:59,1,1,0,1,12000,1,20241031,3-6,심야
6:00 ~ 8:59,0,0,0,0,0,0,20241031,6-9,심야
9:00 ~ 11:59,573,573,2037,4623,68720630,6660,20241031,9-12,주간
12:00 ~ 14:59,1309,1309,4821,10576,447536570,15397,20241031,12-15,주간
15:00 ~ 17:59,1902,1902,10672,20687,1413712170,31359,20241031,15-18,주간
18:00 ~ 20:59,2861,2861,35690,48110,3415709825,83800,20241031,18-21,저녁
21:00 ~ 23:59,8,8,190,-4,-2764600,186,20241031,21-24,저녁
합계,6654,6654,53410,83993,5342926595,137403,20241031,,
00:00 ~ 2:59,0,0,0,0,0,0,20241101,0-3,심야
3:00 ~ 5:59,0,0,0,0,0,0,20241101,3-6,심야
6:00 ~ 8:59,0,0,0,0,0,0,20241101,6-9,심야
9:00 ~ 11:59,572,572,2445,3379,77814600,5824,20241101,9-12,주간
12:00 ~ 14:59,1406,1406,6058,11933,514474098,17991,20241101,12-15,주간
15:00 ~ 17:59,2036,2036,13177,29111,1921650500,42288,20241101,15-18,주간
18:00 ~ 20:59,2861,2861,32693,44164,2844723660,76857,20241101,18-21,저녁
21:00 ~ 23:59,12,12,152,87,2491400,239,20241101,21-24,저녁
합계,6887,6887,54525,88674,5361154258,143199,20241101,,
00:00 ~ 2:59,0,0,0,0,0,0,20241102,0-3,심야
3:00 ~ 5:59,0,0,0,0,0,0,20241102,3-6,심야
6:00 ~ 8:59,0,0,0,0,0,0,20241102,6-9,심야
9:00 ~ 11:59,515,515,1145,2544,65654880,3689,20241102,9-12,주간
12:00 ~ 14:59,1297,1297,5643,9503,383058480,15146,20241102,12-15,주간
15:00 ~ 17:59,1836,1836,10259,15447,713373721,25706,20241102,15-18,주간
18:00 ~ 20:59,2456,2456,18512,18283,863355725,36795,20241102,18-21,저녁
21:00 ~ 23:59,10,10,135,43,2924400,178,20241102,21-24,저녁
합계,6114,6114,35694,45820,2028367206,81514,20241102,,
00:00 ~ 2:59,0,0,0,0,0,0,20241103,0-3,심야
3:00 ~ 5:59,0,0,0,0,0,0,20241103,3-6,심야
6:00 ~ 8:59,0,0,0,0,0,0,20241103,6-9,심야
9:00 ~ 11:59,472,472,1171,1733,47193930,2904,20241103,9-12,주간
12:00 ~ 14:59,1169,1169,4201,6105,304621370,10306,20241103,12-15,주간
15:00 ~ 17:59,1644,1644,6980,10335,516241000,17315,20241103,15-18,주간
18:00 ~ 20:59,2387,2387,15911,10249,727717830,26160,20241103,18-21,저녁
21:00 ~ 23:59,8,8,130,-12,-2266400,118,20241103,21-24,저녁
합계,5680,5680,28393,28410,1593507730,56803,20241103,,
00:00 ~ 2:59,0,0,0,0,0,0,20241104,0-3,심야
3:00 ~ 5:59,0,0,0,0,0,0,20241104,3-6,심야
6:00 ~ 8:59,0,0,0,0,0,0,20241104,6-9,심야
9:00 ~ 11:59,504,504,1139,3501,56194060,4640,20241104,9-12,주간
12:00 ~ 14:59,1143,1143,3813,6390,369038974,10203,20241104,12-15,주간
15:00 ~ 17:59,1687,1687,6741,13357,660882700,20098,20241104,15-18,주간
18:00 ~ 20:59,2527,2527,20146,20851,880757880,40997,20241104,18-21,저녁
21:00 ~ 23:59,10,10,254,-17,-4968200,237,20241104,21-24,저녁
합계,5871,5871,32093,44082,1961905414,76175,20241104,,
00:00 ~ 2:59,0,0,0,0,0,0,20241105,0-3,심야
3:00 ~ 5:59,1,1,0,2,58000,2,20241105,3-6,심야
6:00 ~ 8:59,0,0,0,0,0,0,20241105,6-9,심야
9:00 ~ 11:59,512,512,1314,3014,62966850,4328,20241105,9-12,주간
12:00 ~ 14:59,1175,1175,6205,16065,1461506190,22270,20241105,12-15,주간
15:00 ~ 17:59,1729,1729,8145,16521,1207639890,24666,20241105,15-18,주간
18:00 ~ 20:59,2655,2655,27933,46982,3415247044,74915,20241105,18-21,저녁
21:00 ~ 23:59,10,10,154,1050,75991500,1204,20241105,21-24,저녁
합계,6082,6082,43751,83634,6223409474,127385,20241105,,
00:00 ~ 2:59,0,0,0,0,0,0,20241106,0-3,심야
3:00 ~ 5:59,0,0,0,0,0,0,20241106,3-6,심야
6:00 ~ 8:59,0,0,0,0,0,0,20241106,6-9,심야
9:00 ~ 11:59,519,519,1625,3124,65359250,4749,20241106,9-12,주간
12:00 ~ 14:59,1269,1269,5154,12968,1178814980,18122,20241106,12-15,주간
15:00 ~ 17:59,1781,1781,8288,16905,1118864080,25193,20241106,15-18,주간
18:00 ~ 20:59,2775,2775,31519,45722,4287589600,77241,20241106,18-21,저녁
21:00 ~ 23:59,12,12,85,330,15284400,415,20241106,21-24,저녁
합계,6356,6356,46671,79049,6665912310,125720,20241106,,
00:00 ~ 2:59,0,0,0,0,0,0,20241107,0-3,심야
3:00 ~ 5:59,0,0,0,0,0,0,20241107,3-6,심야
6:00 ~ 8:59,0,0,0,0,0,0,20241107,6-9,심야
9:00 ~ 11:59,533,533,2048,3450,57146680,5498,20241107,9-12,주간
12:00 ~ 14:59,1312,1312,6279,14323,1161850340,20602,20241107,12-15,주간
15:00 ~ 17:59,1884,1884,7865,21400,1476719780,29265,20241107,15-18,주간
18:00 ~ 20:59,2765,2765,24649,48994,3104286270,73643,20241107,18-21,저녁
21:00 ~ 23:59,22,22,78,98,5281500,176,20241107,21-24,저녁
합계,6516,6516,40919,88265,5805284570,129184,20241107,,
00:00 ~ 2:59,0,0,0,0,0,0,20241108,0-3,심야
3:00 ~ 5:59,0,0,0,0,0,0,20241108,3-6,심야
6:00 ~ 8:59,0,0,0,0,0,0,20241108,6-9,심야
9:00 ~ 11:59,568,568,2314,3242,63189870,5556,20241108,9-12,주간
12:00 ~ 14:59,1396,1396,7301,13420,842044960,20721,20241108,12-15,주간
15:00 ~ 17:59,1963,1963,9451,21514,919278010,30965,20241108,15-18,주간
18:00 ~ 20:59,2807,2807,23756,34235,2107029090,57991,20241108,18-21,저녁
21:00 ~ 23:59,12,12,58,173,6001200,231,20241108,21-24,저녁
합계,6746,6746,42880,72584,3937543130,115464,20241108,,
00:00 ~ 2:59,0,0,0,0,0,0,20241109,0-3,심야
3:00 ~ 5:59,0,0,0,0,0,0,20241109,3-6,심야
6:00 ~ 8:59,0,0,0,0,0,0,20241109,6-9,심야
9:00 ~ 11:59,497,497,1223,2284,56960340,3507,20241109,9-12,주간
12:00 ~ 14:59,1335,1335,6381,8584,576673930,14965,20241109,12-15,주간
15:00 ~ 17:59,1813,1813,6993,11905,587312930,18898,20241109,15-18,주간
18:00 ~ 20:59,2461,2461,15247,14978,1193955960,30225,20241109,18-21,저녁
21:00 ~ 23:59,8,8,26,33,1518500,59,20241109,21-24,저녁
합계,6114,6114,29870,37784,2416421660,67654,20241109,,
00:00 ~ 2:59,0,0,0,0,0,0,20241110,0-3,심야
3:00 ~ 5:59,0,0,0,0,0,0,20241110,3-6,심야
6:00 ~ 8:59,0,0,0,0,0,0,20241110,6-9,심야
9:00 ~ 11:59,458,458,859,1790,49770900,2649,20241110,9-12,주간
12:00 ~ 14:59,1225,1225,5522,6838,405909170,12360,20241110,12-15,주간
15:00 ~ 17:59,1660,1660,5182,10175,489020020,15357,20241110,15-18,주간
18:00 ~ 20:59,2434,2434,12285,12874,919447960,25159,20241110,18-21,저녁
21:00 ~ 23:59,6,6,31,14,836000,45,20241110,21-24,저녁
합계,5783,5783,23879,31691,1864984050,55570,20241110,,
00:00 ~ 2:59,0,0,0,0,0,0,20241111,0-3,심야
3:00 ~ 5:59,1,1,0,2,58000,2,20241111,3-6,심야
6:00 ~ 8:59,0,0,0,0,0,0,20241111,6-9,심야
9:00 ~ 11:59,517,517,1170,5129,96399660,6299,20241111,9-12,주간
12:00 ~ 14:59,1225,1225,5665,10329,528292000,15994,20241111,12-15,주간
15:00 ~ 17:59,1785,1785,9027,18067,983732150,27094,20241111,15-18,주간
18:00 ~ 20:59,2805,2805,24453,30672,2172085770,55125,20241111,18-21,저녁
21:00 ~ 23:59,9,9,55,33,1439000,88,20241111,21-24,저녁
합계,6342,6342,40370,64232,3782006580,104602,20241111,,
00:00 ~ 2:59,0,0,0,0,0,0,20241112,0-3,심야
3:00 ~ 5:59,0,0,0,0,0,0,20241112,3-6,심야
6:00 ~ 8:59,0,0,0,0,0,0,20241112,6-9,심야
9:00 ~ 11:59,513,513,1919,3286,65411970,5205,20241112,9-12,주간
12:00 ~ 14:59,1266,1266,5965,8662,426806100,14627,20241112,12-15,주간
15:00 ~ 17:59,1811,1811,8116,20846,927782150,28962,20241112,15-18,주간
18:00 ~ 20:59,2932,2932,23682,43497,2192516360,67179,20241112,18-21,저녁
21:00 ~ 23:59,7,7,42,29,1528200,71,20241112,21-24,저녁
합계,6529,6529,39724,76320,3614044780,116044,20241112,,
00:00 ~ 2:59,0,0,0,0,0,0,20241113,0-3,심야
3:00 ~ 5:59,0,0,0,0,0,0,20241113,3-6,심야
6:00 ~ 8:59,0,0,0,0,0,0,20241113,6-9,심야
9:00 ~ 11:59,573,573,1618,4299,93602080,5917,20241113,9-12,주간
12:00 ~ 14:59,1352,1352,5740,10690,549368770,16430,20241113,12-15,주간
15:00 ~ 17:59,1916,1916,9459,16361,994784000,25820,20241113,15-18,주간
18:00 ~ 20:59,2972,2972,23223,35996,2138631780,59219,20241113,18-21,저녁
21:00 ~ 23:59,11,11,44,26,409700,70,20241113,21-24,저녁
합계,6824,6824,40084,67372,3776796330,107456,20241113,,
00:00 ~ 2:59,0,0,0,0,0,0,20241114,0-3,심야
3:00 ~ 5:59,0,0,0,0,0,0,20241114,3-6,심야
6:00 ~ 8:59,0,0,0,0,0,0,20241114,6-9,심야
9:00 ~ 11:59,620,620,2092,3628,78266740,5720,20241114,9-12,주간
12:00 ~ 14:59,1396,1396,6638,13052,744537560,19690,20241114,12-15,주간
15:00 ~ 17:59,1983,1983,9831,20480,1293485550,30311,20241114,15-18,주간
18:00 ~ 20:59,2973,2973,24155,41185,2372562770,65340,20241114,18-21,저녁
21:00 ~ 23:59,8,8,27,25,658400,52,20241114,21-24,저녁
합계,6980,6980,42743,78370,4489511020,121113,20241114,,
00:00 ~ 2:59,0,0,0,0,0,0,20241115,0-3,심야
3:00 ~ 5:59,0,0,0,0,0,0,20241115,3-6,심야
6:00 ~ 8:59,0,0,0,0,0,0,20241115,6-9,심야
9:00 ~ 11:59,644,644,2501,5607,91511540,8108,20241115,9-12,주간
12:00 ~ 14:59,1454,1454,6202,12683,789477300,18885,20241115,12-15,주간
15:00 ~ 17:59,2151,2151,15838,50959,5419031610,66797,20241115,15-18,주간
18:00 ~ 20:59,3080,3080,29507,66847,7041879813,96354,20241115,18-21,저녁
21:00 ~ 23:59,11,11,48,59,2881650,107,20241115,21-24,저녁
합계,7340,7340,54096,136155,13344781913,190251,20241115,,
00:00 ~ 2:59,0,0,0,0,0,0,20241116,0-3,심야
3:00 ~ 5:59,0,0,0,0,0,0,20241116,3-6,심야
6:00 ~ 8:59,0,0,0,0,0,0,20241116,6-9,심야
9:00 ~ 11:59,537,537,1016,2774,61265420,3790,20241116,9-12,주간
12:00 ~ 14:59,1437,1437,5115,8049,430800742,13164,20241116,12-15,주간
15:00 ~ 17:59,1973,1973,9257,13997,702400470,23254,20241116,15-18,주간
18:00 ~ 20:59,2617,2617,15294,19629,1267964735,34923,20241116,18-21,저녁
21:00 ~ 23:59,7,7,35,32,2340500,67,20241116,21-24,저녁
합계,6571,6571,30717,44481,2464771867,75198,20241116,,
00:00 ~ 2:59,0,0,0,0,0,0,20241117,0-3,심야
3:00 ~ 5:59,0,0,0,0,0,0,20241117,3-6,심야
6:00 ~ 8:59,0,0,0,0,0,0,20241117,6-9,심야
9:00 ~ 11:59,513,513,1030,2303,51540310,3333,20241117,9-12,주간
12:00 ~ 14:59,1325,1325,5260,7301,364286860,12561,20241117,12-15,주간
15:00 ~ 17:59,1793,1793,6743,11164,530202360,17907,20241117,15-18,주간
18:00 ~ 20:59,2559,2559,12945,13782,1027344274,26727,20241117,18-21,저녁
21:00 ~ 23:59,7,7,40,-1,-787200,39,20241117,21-24,저녁
합계,6197,6197,26018,34549,1972586604,60567,20241117,,
00:00 ~ 2:59,0,0,0,0,0,0,20241118,0-3,심야
3:00 ~ 5:59,0,0,0,0,0,0,20241118,3-6,심야
6:00 ~ 8:59,0,0,0,0,0,0,20241118,6-9,심야
9:00 ~ 11:59,548,548,1108,3170,64219140,4278,20241118,9-12,주간
12:00 ~ 14:59,1347,1347,4739,7550,411258860,12289,20241118,12-15,주간
15:00 ~ 17:59,1891,1891,8802,17691,632419270,26493,20241118,15-18,주간
18:00 ~ 20:59,2891,2891,22937,31895,1407400099,54832,20241118,18-21,저녁
21:00 ~ 23:59,9,9,52,26,1680500,78,20241118,21-24,저녁
합계,6686,6686,37638,60332,2516977869,97970,20241118,,
00:00 ~ 2:59,0,0,0,0,0,0,20241119,0-3,심야
3:00 ~ 5:59,1,1,0,2,58000,2,20241119,3-6,심야
6:00 ~ 8:59,0,0,0,0,0,0,20241119,6-9,심야
9:00 ~ 11:59,637,637,3275,6745,94796880,10020,20241119,9-12,주간
12:00 ~ 14:59,1427,1427,6266,17548,807589520,23814,20241119,12-15,주간
15:00 ~ 17:59,2005,2005,10833,17785,1185741900,28618,20241119,15-18,주간
18:00 ~ 20:59,3112,3112,30774,69125,6529993898,99899,20241119,18-21,저녁
21:00 ~ 23:59,11,11,47,616,508350,663,20241119,21-24,저녁
합계,7193,7193,51195,111821,8618688548,163016,20241119,,
00:00 ~ 2:59,0,0,0,0,0,0,20241120,0-3,심야
3:00 ~ 5:59,0,0,0,0,0,0,20241120,3-6,심야
6:00 ~ 8:59,0,0,0,0,0,0,20241120,6-9,심야
9:00 ~ 11:59,669,669,2913,8236,191182450,11149,20241120,9-12,주간
12:00 ~ 14:59,1522,1522,6288,14370,577982930,20658,20241120,12-15,주간
15:00 ~ 17:59,2133,2133,12138,70144,8140357850,82282,20241120,15-18,주간
18:00 ~ 20:59,3205,3205,30877,116338,11072809793,147215,20241120,18-21,저녁
21:00 ~ 23:59,12,12,81,83,3376400,164,20241120,21-24,저녁
합계,7541,7541,52297,209171,19985709423,261468,20241120,,
00:00 ~ 2:59,0,0,0,0,0,0,20241121,0-3,심야
3:00 ~ 5:59,0,0,0,0,0,0,20241121,3-6,심야
6:00 ~ 8:59,0,0,0,0,0,0,20241121,6-9,심야
9:00 ~ 11:59,702,702,2894,5898,113397170,8792,20241121,9-12,주간
12:00 ~ 14:59,1540,1540,6716,13998,872512102,20714,20241121,12-15,주간
15:00 ~ 17:59,2151,2151,10714,25313,1326351760,36027,20241121,15-18,주간
18:00 ~ 20:59,3189,3189,25075,45170,2164312590,70245,20241121,18-21,저녁
21:00 ~ 23:59,17,17,63,57,2686250,120,20241121,21-24,저녁
합계,7599,7599,45462,90436,4479259872,135898,20241121,,
00:00 ~ 2:59,0,0,0,0,0,0,20241122,0-3,심야
3:00 ~ 5:59,1,1,0,1,12000,1,20241122,3-6,심야
6:00 ~ 8:59,0,0,0,0,0,0,20241122,6-9,심야
9:00 ~ 11:59,652,652,3131,6364,102198619,9495,20241122,9-12,주간
12:00 ~ 14:59,1572,1572,8297,19083,1325898031,27380,20241122,12-15,주간
15:00 ~ 17:59,2188,2188,11975,45930,5013628800,57905,20241122,15-18,주간
18:00 ~ 20:59,3171,3171,28770,43116,2360815211,71886,20241122,18-21,저녁
21:00 ~ 23:59,13,13,62,65,2213700,127,20241122,21-24,저녁
합계,7597,7597,52235,114559,8804766361,166794,20241122,,
00:00 ~ 2:59,1,1,2,-2,-70000,0,20241123,0-3,심야
3:00 ~ 5:59,2,2,8,-6,-174000,2,20241123,3-6,심야
6:00 ~ 8:59,0,0,0,0,0,0,20241123,6-9,심야
9:00 ~ 11:59,585,585,1151,2721,61167930,3872,20241123,9-12,주간
12:00 ~ 14:59,1509,1509,6373,8470,527881870,14843,20241123,12-15,주간
15:00 ~ 17:59,2044,2044,9569,19187,1381946180,28756,20241123,15-18,주간
18:00 ~ 20:59,2681,2681,14660,16178,1099455268,30838,20241123,18-21,저녁
21:00 ~ 23:59,12,12,34,30,2833300,64,20241123,21-24,저녁
합계,6834,6834,31797,46578,3073040548,78375,20241123,,
00:00 ~ 2:59,0,0,0,0,0,0,20241124,0-3,심야
3:00 ~ 5:59,0,0,0,0,0,0,20241124,3-6,심야
6:00 ~ 8:59,0,0,0,0,0,0,20241124,6-9,심야
9:00 ~ 11:59,574,574,799,2402,55219540,3201,20241124,9-12,주간
12:00 ~ 14:59,1441,1441,5931,8182,450953200,14113,20241124,12-15,주간
15:00 ~ 17:59,1901,1901,7862,11697,570214370,19559,20241124,15-18,주간
18:00 ~ 20:59,2683,2683,12626,13316,962156581,25942,20241124,18-21,저녁
21:00 ~ 23:59,15,15,111,161,4863000,272,20241124,21-24,저녁
합계,6614,6614,27329,35758,2043406691,63087,20241124,,
00:00 ~ 2:59,0,0,0,0,0,0,20241125,0-3,심야
3:00 ~ 5:59,0,0,0,0,0,0,20241125,3-6,심야
6:00 ~ 8:59,0,0,0,0,0,0,20241125,6-9,심야
9:00 ~ 11:59,587,587,1571,6981,64046660,8552,20241125,9-12,주간
12:00 ~ 14:59,1436,1436,6854,11969,497483410,18823,20241125,12-15,주간
15:00 ~ 17:59,1972,1972,10981,27113,1709915900,38094,20241125,15-18,주간
18:00 ~ 20:59,3054,3054,22918,33951,1905671514,56869,20241125,18-21,저녁
21:00 ~ 23:59,23,23,54,57,3109800,111,20241125,21-24,저녁
합계,7072,7072,42378,80071,4180227284,122449,20241125,,
00:00 ~ 2:59,0,0,0,0,0,0,20241126,0-3,심야
3:00 ~ 5:59,1,1,0,1,12000,1,20241126,3-6,심야
6:00 ~ 8:59,0,0,0,0,0,0,20241126,6-9,심야
9:00 ~ 11:59,615,615,2883,3394,67022320,6277,20241126,9-12,주간
12:00 ~ 14:59,1526,1526,7956,15112,1171840830,23068,20241126,12-15,주간
15:00 ~ 17:59,1995,1995,9705,16522,918072470,26227,20241126,15-18,주간
18:00 ~ 20:59,3137,3137,25354,42486,3109719618,67840,20241126,18-21,저녁
21:00 ~ 23:59,18,18,47,72,7955600,119,20241126,21-24,저녁
합계,7292,7292,45945,77587,5274622838,123532,20241126,,
00:00 ~ 2:59,0,0,0,0,0,0,20241127,0-3,심야
3:00 ~ 5:59,1,1,0,5,60000,5,20241127,3-6,심야
6:00 ~ 8:59,0,0,0,0,0,0,20241127,6-9,심야
9:00 ~ 11:59,582,582,2334,3713,56958460,6047,20241127,9-12,주간
12:00 ~ 14:59,1494,1494,8494,17884,1491859380,26378,20241127,12-15,주간
15:00 ~ 17:59,2056,2056,14396,17838,1287039980,32234,20241127,15-18,주간
18:00 ~ 20:59,3145,3145,29145,43615,3219753936,72760,20241127,18-21,저녁
21:00 ~ 23:59,21,21,82,85,7666300,167,20241127,21-24,저녁
합계,7299,7299,54451,83140,6063338056,137591,20241127,,
00:00 ~ 2:59,0,0,0,0,0,0,20241128,0-3,심야
3:00 ~ 5:59,1,1,0,1,12000,1,20241128,3-6,심야
6:00 ~ 8:59,0,0,0,0,0,0,20241128,6-9,심야
9:00 ~ 11:59,590,590,2051,2939,57750180,4990,20241128,9-12,주간
12:00 ~ 14:59,1551,1551,27741,15499,1297124771,43240,20241128,12-15,주간
15:00 ~ 17:59,2040,2040,10106,17080,954856190,27186,20241128,15-18,주간
18:00 ~ 20:59,3091,3091,28362,78469,10686766301,106831,20241128,18-21,저녁
21:00 ~ 23:59,25,25,117,244,11229800,361,20241128,21-24,저녁
합계,7298,7298,68377,114232,13007739242,182609,20241128,,
00:00 ~ 2:59,0,0,0,0,0,0,20241129,0-3,심야
3:00 ~ 5:59,0,0,0,0,0,0,20241129,3-6,심야
6:00 ~ 8:59,0,0,0,0,0,0,20241129,6-9,심야
9:00 ~ 11:59,597,597,1925,3646,75036810,5571,20241129,9-12,주간
12:00 ~ 14:59,1678,1678,11052,15552,852689583,26604,20241129,12-15,주간
15:00 ~ 17:59,2192,2192,10361,21873,908243200,32234,20241129,15-18,주간
18:00 ~ 20:59,3235,3235,28683,57635,4355036846,86318,20241129,18-21,저녁
21:00 ~ 23:59,23,23,66,93,5113300,159,20241129,21-24,저녁
합계,7725,7725,52087,98799,6196119739,150886,20241129,,
00:00 ~ 2:59,0,0,0,0,0,0,20241130,0-3,심야
3:00 ~ 5:59,0,0,0,0,0,0,20241130,3-6,심야
6:00 ~ 8:59,0,0,0,0,0,0,20241130,6-9,심야
9:00 ~ 11:59,589,589,1509,2351,57555770,3860,20241130,9-12,주간
12:00 ~ 14:59,1651,1651,7912,9370,581390750,17282,20241130,12-15,주간
15:00 ~ 17:59,2132,2132,9508,15659,696747440,25167,20241130,15-18,주간
18:00 ~ 20:59,2859,2859,18213,18811,1351014191,37024,20241130,18-21,저녁
21:00 ~ 23:59,18,18,72,34,732600,106,20241130,21-24,저녁
합계,7249,7249,37214,46225,2687440751,83439,20241130,,
00:00 ~ 2:59,0,0,0,0,0,0,20241201,0-3,심야
3:00 ~ 5:59,0,0,0,0,0,0,20241201,3-6,심야
6:00 ~ 8:59,0,0,0,0,0,0,20241201,6-9,심야
9:00 ~ 11:59,618,618,1041,2836,73085840,3877,20241201,9-12,주간
12:00 ~ 14:59,1657,1657,7368,9771,553542290,17139,20241201,12-15,주간
15:00 ~ 17:59,2153,2153,7881,13001,642233240,20882,20241201,15-18,주간
18:00 ~ 20:59,2933,2933,15019,17719,1201058215,32738,20241201,18-21,저녁
21:00 ~ 23:59,28,28,70,67,2710500,137,20241201,21-24,저녁
합계,7389,7389,31379,43394,2472630085,74773,20241201,,
00:00 ~ 2:59,0,0,0,0,0,0,20241202,0-3,심야
3:00 ~ 5:59,0,0,0,0,0,0,20241202,3-6,심야
6:00 ~ 8:59,0,0,0,0,0,0,20241202,6-9,심야
9:00 ~ 11:59,630,630,1334,3509,64210400,4843,20241202,9-12,주간
12:00 ~ 14:59,1588,1588,6209,9363,511643150,15572,20241202,12-15,주간
15:00 ~ 17:59,2171,2171,9504,20771,1752002400,30275,20241202,15-18,주간
18:00 ~ 20:59,3232,3232,20670,30229,1297260382,50899,20241202,18-21,저녁
21:00 ~ 23:59,23,23,96,49,1289850,145,20241202,21-24,저녁
합계,7644,7644,37813,63921,3626406182,101734,20241202,,
00:00 ~ 2:59,0,0,0,0,0,0,20241203,0-3,심야
3:00 ~ 5:59,0,0,0,0,0,0,20241203,3-6,심야
6:00 ~ 8:59,0,0,0,0,0,0,20241203,6-9,심야
9:00 ~ 11:59,664,664,2671,3594,67057600,6265,20241203,9-12,주간
12:00 ~ 14:59,1625,1625,34117,10161,488227250,44278,20241203,12-15,주간
15:00 ~ 17:59,2222,2222,10878,20383,1157549280,31261,20241203,15-18,주간
18:00 ~ 20:59,3277,3277,25685,34627,1498676330,60312,20241203,18-21,저녁
21:00 ~ 23:59,30,30,111,63,1364750,174,20241203,21-24,저녁
합계,7818,7818,73462,68828,3212875210,142290,20241203,,
00:00 ~ 2:59,0,0,0,0,0,0,20241204,0-3,심야
3:00 ~ 5:59,0,0,0,0,0,0,20241204,3-6,심야
6:00 ~ 8:59,0,0,0,0,0,0,20241204,6-9,심야
9:00 ~ 11:59,606,606,1712,3637,61225380,5349,20241204,9-12,주간
12:00 ~ 14:59,1605,1605,10976,21323,2136629600,32299,20241204,12-15,주간
15:00 ~ 17:59,2108,2108,14978,21616,1609125850,36594,20241204,15-18,주간
18:00 ~ 20:59,3055,3055,35239,57475,5247211039,92714,20241204,18-21,저녁
21:00 ~ 23:59,31,31,83,70,5172450,153,20241204,21-24,저녁
합계,7405,7405,62988,104121,9059364319,167109,20241204,,
00:00 ~ 2:59,0,0,0,0,0,0,20241205,0-3,심야
3:00 ~ 5:59,1,1,1,0,0,1,20241205,3-6,심야
6:00 ~ 8:59,0,0,0,0,0,0,20241205,6-9,심야
9:00 ~ 11:59,648,648,2498,5531,82419420,8029,20241205,9-12,주간
12:00 ~ 14:59,1693,1693,10349,18166,1444457840,28515,20241205,12-15,주간
15:00 ~ 17:59,2182,2182,10772,16541,1165686410,27313,20241205,15-18,주간
18:00 ~ 20:59,3204,3204,28452,50308,3417621814,78760,20241205,18-21,저녁
21:00 ~ 23:59,27,27,62,58,3343700,120,20241205,21-24,저녁
합계,7755,7755,52134,90604,6113529184,142738,20241205,,
00:00 ~ 2:59,0,0,0,0,0,0,20241206,0-3,심야
3:00 ~ 5:59,0,0,0,0,0,0,20241206,3-6,심야
6:00 ~ 8:59,0,0,0,0,0,0,20241206,6-9,심야
9:00 ~ 11:59,622,622,2243,4493,97471710,6736,20241206,9-12,주간
12:00 ~ 14:59,1667,1667,11961,12686,688200470,24647,20241206,12-15,주간
15:00 ~ 17:59,2162,2162,13930,19684,1267190350,33614,20241206,15-18,주간
18:00 ~ 20:59,2972,2972,27460,29839,1746873264,57299,20241206,18-21,저녁
21:00 ~ 23:59,26,26,46,203,10958600,249,20241206,21-24,저녁
합계,7449,7449,55640,66905,3810694394,122545,20241206,,
00:00 ~ 2:59,0,0,0,0,0,0,20241207,0-3,심야
3:00 ~ 5:59,0,0,0,0,0,0,20241207,3-6,심야
6:00 ~ 8:59,0,0,0,0,0,0,20241207,6-9,심야
9:00 ~ 11:59,588,588,3616,2591,51513690,6207,20241207,9-12,주간
12:00 ~ 14:59,1606,1606,12795,5633,414927480,18428,20241207,12-15,주간
15:00 ~ 17:59,2041,2041,11900,13345,567030040,25245,20241207,15-18,주간
18:00 ~ 20:59,2632,2632,26661,14480,1208377900,41141,20241207,18-21,저녁
21:00 ~ 23:59,27,27,51,58,2616100,109,20241207,21-24,저녁
합계,6894,6894,55023,36107,2244465210,91130,20241207,,
00:00 ~ 2:59,0,0,0,0,0,0,20241208,0-3,심야
3:00 ~ 5:59,0,0,0,0,0,0,20241208,3-6,심야
6:00 ~ 8:59,0,0,0,0,0,0,20241208,6-9,심야
9:00 ~ 11:59,615,615,3485,462,35635370,3947,20241208,9-12,주간
12:00 ~ 14:59,1601,1601,9787,5914,455254612,15701,20241208,12-15,주간
15:00 ~ 17:59,1924,1924,11497,7135,424159600,18632,20241208,15-18,주간
18:00 ~ 20:59,2552,2552,14039,10822,884572533,24861,20241208,18-21,저녁
21:00 ~ 23:59,35,35,56,63,2952850,119,20241208,21-24,저녁
합계,6727,6727,38864,24396,1802574965,63260,20241208,,
00:00 ~ 2:59,0,0,0,0,0,0,20241209,0-3,심야
3:00 ~ 5:59,0,0,0,0,0,0,20241209,3-6,심야
6:00 ~ 8:59,0,0,0,0,0,0,20241209,6-9,심야
9:00 ~ 11:59,615,615,2479,4350,69275430,6829,20241209,9-12,주간
12:00 ~ 14:59,1542,1542,12400,18627,1292263220,31027,20241209,12-15,주간
15:00 ~ 17:59,1992,1992,9600,15575,1062126392,25175,20241209,15-18,주간
18:00 ~ 20:59,2876,2876,30305,35542,2529312350,65847,20241209,18-21,저녁
21:00 ~ 23:59,40,40,69,338,2784800,407,20241209,21-24,저녁
합계,7065,7065,54853,74432,4955762192,129285,20241209,,
00:00 ~ 2:59,0,0,0,0,0,0,20241210,0-3,심야
3:00 ~ 5:59,0,0,0,0,0,0,20241210,3-6,심야
6:00 ~ 8:59,1,1,0,1,30000,1,20241210,6-9,심야
9:00 ~ 11:59,676,676,2349,3661,86659140,6010,20241210,9-12,주간
12:00 ~ 14:59,1639,1639,9937,10923,468283560,20860,20241210,12-15,주간
15:00 ~ 17:59,2111,2111,9921,16339,650588140,26260,20241210,15-18,주간
18:00 ~ 20:59,3059,3059,27356,37068,1328595267,64424,20241210,18-21,저녁
21:00 ~ 23:59,41,41,95,238,7660000,333,20241210,21-24,저녁
합계,7527,7527,49658,68230,2541816107,117888,20241210,,
00:00 ~ 2:59,0,0,0,0,0,0,20241211,0-3,심야
3:00 ~ 5:59,0,0,0,0,0,0,20241211,3-6,심야
6:00 ~ 8:59,0,0,0,0,0,0,20241211,6-9,심야
9:00 ~ 11:59,689,689,2556,4481,86402570,7037,20241211,9-12,주간
12:00 ~ 14:59,1659,1659,8673,8905,452275290,17578,20241211,12-15,주간
15:00 ~ 17:59,2107,2107,10495,14229,642297130,24724,20241211,15-18,주간
18:00 ~ 20:59,2991,2991,29626,36366,2659432770,65992,20241211,18-21,저녁
21:00 ~ 23:59,43,43,188,963,34306250,1151,20241211,21-24,저녁
합계,7489,7489,51538,64944,3874714010,116482,20241211,,
00:00 ~ 2:59,0,0,0,0,0,0,20241212,0-3,심야
3:00 ~ 5:59,1,1,0,2,30000,2,20241212,3-6,심야
6:00 ~ 8:59,0,0,0,0,0,0,20241212,6-9,심야
9:00 ~ 11:59,709,709,2473,4281,96857570,6754,20241212,9-12,주간
12:00 ~ 14:59,1688,1688,10975,8772,549202270,19747,20241212,12-15,주간
15:00 ~ 17:59,2079,2079,10643,14556,681697145,25199,20241212,15-18,주간
18:00 ~ 20:59,2938,2938,29025,29460,1587359425,58485,20241212,18-21,저녁
21:00 ~ 23:59,39,39,111,211,7409850,322,20241212,21-24,저녁
합계,7454,7454,53227,57282,2922556260,110509,20241212,,
00:00 ~ 2:59,0,0,0,0,0,0,20241213,0-3,심야
3:00 ~ 5:59,2,2,0,11,165000,11,20241213,3-6,심야
6:00 ~ 8:59,1,1,0,4,60000,4,20241213,6-9,심야
9:00 ~ 11:59,713,713,3802,4085,107592120,7887,20241213,9-12,주간
12:00 ~ 14:59,1807,1807,9817,13519,730370940,23336,20241213,12-15,주간
15:00 ~ 17:59,2079,2079,11011,18874,1251686610,29885,20241213,15-18,주간
18:00 ~ 20:59,2913,2913,22661,36682,2626744752,59343,20241213,18-21,저녁
21:00 ~ 23:59,42,42,187,92,1006800,279,20241213,21-24,저녁
합계,7557,7557,47478,73267,4717626222,120745,20241213,,
00:00 ~ 2:59,0,0,0,0,0,0,20241214,0-3,심야
3:00 ~ 5:59,0,0,0,0,0,0,20241214,3-6,심야
6:00 ~ 8:59,0,0,0,0,0,0,20241214,6-9,심야
9:00 ~ 11:59,681,681,2525,2894,59651740,5419,20241214,9-12,주간
12:00 ~ 14:59,1727,1727,9323,10515,477484036,19838,20241214,12-15,주간
15:00 ~ 17:59,2012,2012,12862,8596,581656340,21458,20241214,15-18,주간
18:00 ~ 20:59,2546,2546,20231,14504,974086831,34735,20241214,18-21,저녁
21:00 ~ 23:59,30,30,87,86,4944800,173,20241214,21-24,저녁
합계,6996,6996,45028,36595,2097823747,81623,20241214,,
00:00 ~ 2:59,0,0,0,0,0,0,20241215,0-3,심야
3:00 ~ 5:59,0,0,0,0,0,0,20241215,3-6,심야
6:00 ~ 8:59,0,0,0,0,0,0,20241215,6-9,심야
9:00 ~ 11:59,633,633,2064,2380,62432930,4444,20241215,9-12,주간
12:00 ~ 14:59,1689,1689,8232,7936,426592987,16168,20241215,12-15,주간
15:00 ~ 17:59,1976,1976,9641,10421,480851146,20062,20241215,15-18,주간
18:00 ~ 20:59,2516,2516,13750,13536,823611125,27286,20241215,18-21,저녁
21:00 ~ 23:59,40,40,70,219,3551300,289,20241215,21-24,저녁
합계,6854,6854,33757,34492,1797039488,68249,20241215,,
00:00 ~ 2:59,0,0,0,0,0,0,20241216,0-3,심야
3:00 ~ 5:59,0,0,0,0,0,0,20241216,3-6,심야
6:00 ~ 8:59,0,0,0,0,0,0,20241216,6-9,심야
9:00 ~ 11:59,646,646,2174,3956,74260950,6130,20241216,9-12,주간
12:00 ~ 14:59,1664,1664,7180,10280,454183466,17460,20241216,12-15,주간
15:00 ~ 17:59,1898,1898,9082,13562,985908140,22644,20241216,15-18,주간
18:00 ~ 20:59,2778,2778,19466,24379,1471431715,43845,20241216,18-21,저녁
21:00 ~ 23:59,37,37,127,121,2649400,248,20241216,21-24,저녁
합계,7023,7023,38029,52298,2988433671,90327,20241216,,
00:00 ~ 2:59,0,0,0,0,0,0,20241217,0-3,심야
3:00 ~ 5:59,0,0,0,0,0,0,20241217,3-6,심야
6:00 ~ 8:59,0,0,0,0,0,0,20241217,6-9,심야
9:00 ~ 11:59,660,660,3376,3613,108189090,6989,20241217,9-12,주간
12:00 ~ 14:59,1671,1671,7957,13607,724146562,21564,20241217,12-15,주간
15:00 ~ 17:59,2017,2017,8395,13426,621821720,21821,20241217,15-18,주간
18:00 ~ 20:59,2856,2856,25128,31570,1315738629,56698,20241217,18-21,저녁
21:00 ~ 23:59,39,39,288,101,10341850,389,20241217,21-24,저녁
합계,7243,7243,45144,62317,2780237851,107461,20241217,,
00:00 ~ 2:59,0,0,0,0,0,0,20241218,0-3,심야
3:00 ~ 5:59,0,0,0,0,0,0,20241218,3-6,심야
6:00 ~ 8:59,0,0,0,0,0,0,20241218,6-9,심야
9:00 ~ 11:59,707,707,3060,2857,88390280,5917,20241218,9-12,주간
12:00 ~ 14:59,1718,1718,8349,8251,443721308,16600,20241218,12-15,주간
15:00 ~ 17:59,2087,2087,8949,12206,745152450,21155,20241218,15-18,주간
18:00 ~ 20:59,2847,2847,23937,22311,1362845493,46248,20241218,18-21,저녁
21:00 ~ 23:59,40,40,259,197,8736150,456,20241218,21-24,저녁
합계,7399,7399,44554,45822,2648845681,90376,20241218,,
00:00 ~ 2:59,0,0,0,0,0,0,20241219,0-3,심야
3:00 ~ 5:59,0,0,0,0,0,0,20241219,3-6,심야
6:00 ~ 8:59,0,0,0,0,0,0,20241219,6-9,심야
9:00 ~ 11:59,703,703,4003,3393,96402060,7396,20241219,9-12,주간
12:00 ~ 14:59,1798,1798,8042,14655,836576992,22697,20241219,12-15,주간
15:00 ~ 17:59,2095,2095,8835,17386,724665790,26221,20241219,15-18,주간
18:00 ~ 20:59,2861,2861,23312,31308,1717603826,54620,20241219,18-21,저녁
21:00 ~ 23:59,43,43,283,54,-1991150,337,20241219,21-24,저녁
합계,7500,7500,44475,66796,3373257518,111271,20241219,,
00:00 ~ 2:59,0,0,0,0,0,0,20241220,0-3,심야
3:00 ~ 5:59,0,0,0,0,0,0,20241220,3-6,심야
6:00 ~ 8:59,0,0,0,0,0,0,20241220,6-9,심야
9:00 ~ 11:59,719,719,3666,4563,105878140,8229,20241220,9-12,주간
12:00 ~ 14:59,1882,1882,11702,10560,521562080,22262,20241220,12-15,주간
15:00 ~ 17:59,2208,2208,10626,16851,596534740,27477,20241220,15-18,주간
18:00 ~ 20:59,2688,2688,23238,23546,1239401511,46784,20241220,18-21,저녁
21:00 ~ 23:59,39,39,198,193,6415200,391,20241220,21-24,저녁
합계,7536,7536,49430,55713,2469791671,105143,20241220,,
00:00 ~ 2:59,0,0,0,0,0,0,20241221,0-3,심야
3:00 ~ 5:59,0,0,0,0,0,0,20241221,3-6,심야
6:00 ~ 8:59,0,0,0,0,0,0,20241221,6-9,심야
9:00 ~ 11:59,694,694,2590,3012,77360540,5602,20241221,9-12,주간
12:00 ~ 14:59,1852,1852,10411,8108,418370430,18519,20241221,12-15,주간
15:00 ~ 17:59,2019,2019,10080,13874,490437550,23954,20241221,15-18,주간
18:00 ~ 20:59,2437,2437,27894,3365,816550998,31259,20241221,18-21,저녁
21:00 ~ 23:59,36,36,306,12,-7486200,318,20241221,21-24,저녁
합계,7038,7038,51281,28371,1795233318,79652,20241221,,
00:00 ~ 2:59,0,0,0,0,0,0,20241222,0-3,심야
3:00 ~ 5:59,0,0,0,0,0,0,20241222,3-6,심야
6:00 ~ 8:59,0,0,0,0,0,0,20241222,6-9,심야
9:00 ~ 11:59,645,645,2043,2435,70358580,4478,20241222,9-12,주간
12:00 ~ 14:59,1743,1743,8630,9193,430284550,17823,20241222,12-15,주간
15:00 ~ 17:59,1964,1964,10031,11921,472506865,21952,20241222,15-18,주간
18:00 ~ 20:59,2316,2316,14209,10340,731641640,24549,20241222,18-21,저녁
21:00 ~ 23:59,36,36,112,231,19567500,343,20241222,21-24,저녁
합계,6704,6704,35025,34120,1724359135,69145,20241222,,
00:00 ~ 2:59,0,0,0,0,0,0,20241223,0-3,심야
3:00 ~ 5:59,0,0,0,0,0,0,20241223,3-6,심야
6:00 ~ 8:59,0,0,0,0,0,0,20241223,6-9,심야
9:00 ~ 11:59,717,717,1641,3938,105157670,5579,20241223,9-12,주간
12:00 ~ 14:59,1705,1705,6973,10948,485698708,17921,20241223,12-15,주간
15:00 ~ 17:59,1849,1849,9200,17498,1023425850,26698,20241223,15-18,주간
18:00 ~ 20:59,2501,2501,15560,21621,1248970818,37181,20241223,18-21,저녁
21:00 ~ 23:59,43,43,128,351,19513500,479,20241223,21-24,저녁
합계,6815,6815,33502,54356,2882766546,87858,20241223,,
00:00 ~ 2:59,0,0,0,0,0,0,20241224,0-3,심야
3:00 ~ 5:59,0,0,0,0,0,0,20241224,3-6,심야
6:00 ~ 8:59,0,0,0,0,0,0,20241224,6-9,심야
9:00 ~ 11:59,725,725,3049,4633,297165540,7682,20241224,9-12,주간
12:00 ~ 14:59,1710,1710,8891,14102,935317092,22993,20241224,12-15,주간
15:00 ~ 17:59,1864,1864,9227,14974,828537610,24201,20241224,15-18,주간
18:00 ~ 20:59,2559,2559,19448,25157,1438249509,44605,20241224,18-21,저녁
21:00 ~ 23:59,42,42,130,160,5534300,290,20241224,21-24,저녁
합계,6900,6900,40745,59026,3504804051,99771,20241224,,
00:00 ~ 2:59,0,0,0,0,0,0,20241225,0-3,심야
3:00 ~ 5:59,0,0,0,0,0,0,20241225,3-6,심야
6:00 ~ 8:59,0,0,0,0,0,0,20241225,6-9,심야
9:00 ~ 11:59,667,667,2652,1888,46386020,4540,20241225,9-12,주간
12:00 ~ 14:59,1638,1638,8392,7854,499469800,16246,20241225,12-15,주간
15:00 ~ 17:59,1752,1752,9554,10742,512252039,20296,20241225,15-18,주간
18:00 ~ 20:59,2179,2179,11328,11585,913499050,22913,20241225,18-21,저녁
21:00 ~ 23:59,29,29,58,184,11326900,242,20241225,21-24,저녁
합계,6265,6265,31984,32253,1982933809,64237,20241225,,
00:00 ~ 2:59,0,0,0,0,0,0,20241226,0-3,심야
3:00 ~ 5:59,0,0,0,0,0,0,20241226,3-6,심야
6:00 ~ 8:59,0,0,0,0,0,0,20241226,6-9,심야
9:00 ~ 11:59,655,655,2467,3116,75096110,5583,20241226,9-12,주간
12:00 ~ 14:59,1506,1506,6249,9867,640553290,16116,20241226,12-15,주간
15:00 ~ 17:59,1669,1669,8315,16443,928956240,24758,20241226,15-18,주간
18:00 ~ 20:59,2271,2271,15858,19999,1214110600,35857,20241226,18-21,저녁
21:00 ~ 23:59,14,14,116,91,6106000,207,20241226,21-24,저녁
합계,6115,6115,33005,49516,2864822240,82521,20241226,,
00:00 ~ 2:59,0,0,0,0,0,0,20241227,0-3,심야
3:00 ~ 5:59,0,0,0,0,0,0,20241227,3-6,심야
6:00 ~ 8:59,0,0,0,0,0,0,20241227,6-9,심야
9:00 ~ 11:59,673,673,2481,4121,102926400,6602,20241227,9-12,주간
12:00 ~ 14:59,1577,1577,9187,12697,606224680,21884,20241227,12-15,주간
15:00 ~ 17:59,1719,1719,10139,17676,668680340,27815,20241227,15-18,주간
18:00 ~ 20:59,2272,2272,19781,28650,1389414950,48431,20241227,18-21,저녁
21:00 ~ 23:59,19,19,76,82,2560600,158,20241227,21-24,저녁
합계,6260,6260,41664,63226,2769806970,104890,20241227,,
00:00 ~ 2:59,0,0,0,0,0,0,20241228,0-3,심야
3:00 ~ 5:59,0,0,0,0,0,0,20241228,3-6,심야
6:00 ~ 8:59,0,0,0,0,0,0,20241228,6-9,심야
9:00 ~ 11:59,612,612,2195,3083,75780100,5278,20241228,9-12,주간
12:00 ~ 14:59,1526,1526,8515,7009,321507830,15524,20241228,12-15,주간
15:00 ~ 17:59,1645,1645,8471,11872,428750650,20343,20241228,15-18,주간
18:00 ~ 20:59,1947,1947,13063,9591,621044942,22654,20241228,18-21,저녁
21:00 ~ 23:59,19,19,105,68,4064300,173,20241228,21-24,저녁
합계,5749,5749,32349,31623,1451147822,63972,20241228,,
00:00 ~ 2:59,0,0,0,0,0,0,20241229,0-3,심야
3:00 ~ 5:59,0,0,0,0,0,0,20241229,3-6,심야
6:00 ~ 8:59,0,0,0,0,0,0,20241229,6-9,심야
9:00 ~ 11:59,528,528,1842,1623,52367090,3465,20241229,9-12,주간
12:00 ~ 14:59,1426,1426,6923,6945,369973890,13868,20241229,12-15,주간
15:00 ~ 17:59,1434,1434,8913,8717,332914672,17630,20241229,15-18,주간
18:00 ~ 20:59,1797,1797,7515,9595,543853180,17110,20241229,18-21,저녁
21:00 ~ 23:59,13,13,150,83,6898200,233,20241229,21-24,저녁
합계,5198,5198,25343,26963,1306007032,52306,20241229,,
00:00 ~ 2:59,0,0,0,0,0,0,20241230,0-3,심야
3:00 ~ 5:59,0,0,0,0,0,0,20241230,3-6,심야
6:00 ~ 8:59,0,0,0,0,0,0,20241230,6-9,심야
9:00 ~ 11:59,545,545,1353,2332,60101740,3685,20241230,9-12,주간
12:00 ~ 14:59,1350,1350,5523,6995,393451960,12518,20241230,12-15,주간
15:00 ~ 17:59,1392,1392,5261,6814,370045580,12075,20241230,15-18,주간
18:00 ~ 20:59,1888,1888,11450,11659,607263703,23109,20241230,18-21,저녁
21:00 ~ 23:59,16,16,575,-194,-22331050,381,20241230,21-24,저녁
합계,5191,5191,24162,27606,1408531933,51768,20241230,,
00:00 ~ 2:59,0,0,0,0,0,0,20241231,0-3,심야
3:00 ~ 5:59,0,0,0,0,0,0,20241231,3-6,심야
6:00 ~ 8:59,0,0,0,0,0,0,20241231,6-9,심야
9:00 ~ 11:59,544,544,1706,2430,63374500,4136,20241231,9-12,주간
12:00 ~ 14:59,1349,1349,7463,12653,1161825480,20116,20241231,12-15,주간
15:00 ~ 17:59,1420,1420,5399,7326,320000780,12725,20241231,15-18,주간
18:00 ~ 20:59,1960,1960,12373,21923,1819425596,34296,20241231,18-21,저녁
21:00 ~ 23:59,18,18,509,-59,9399800,450,20241231,21-24,저녁
합계,5291,5291,27450,44273,3374026156,71723,20241231,,
