장르,공연건수,상연횟수,취소수,총 티켓판매수,총 티켓판매액,예매수,날짜
연극,153,1212,2703,4742,138245444,7445,20230101
연극,140,1276,1902,4907,128094677,6809,20230102
연극,141,1315,2666,5740,154261237,8406,20230103
연극,140,1322,3856,5707,145215829,9563,20230104
연극,152,1397,6174,10860,371096790,17034,20230105
연극,145,1363,3589,6719,165420700,10308,20230106
연극,132,1245,3567,7085,163013640,10652,20230107
연극,145,1237,2828,6185,144598380,9013,20230108
연극,140,1272,2483,6632,160185040,9115,20230109
연극,153,1347,3584,9981,155725270,13565,20230110
연극,149,1363,3472,6867,251016100,10339,20230111
연극,151,1352,5005,12721,496886720,17726,20230112
연극,160,1433,3594,13137,316134160,16731,20230113
연극,142,1273,3738,8732,245785750,12470,20230114
연극,139,1200,3188,6330,180020050,9518,20230115
연극,138,1166,2721,5130,145366040,7851,20230116
연극,147,1338,3059,6982,214612910,10041,20230117
연극,152,1306,4573,5514,151883610,10087,20230118
연극,153,1317,5849,9045,426334680,14894,20230119
연극,157,1320,5274,5596,157474007,10870,20230120
연극,154,1197,2596,5014,135571060,7610,20230121
연극,144,1141,2426,5240,129067440,7666,20230122
연극,148,1158,2591,6349,155309187,8940,20230123
연극,147,1228,3483,4935,131895517,8418,20230124
연극,157,1298,2401,8685,153210770,11086,20230125
연극,165,1332,3654,5619,148662970,9273,20230126
연극,160,1318,3563,6886,166623300,10449,20230127
연극,151,1252,3161,7965,179929182,11126,20230128
연극,149,1185,4753,5982,151820420,10735,20230129
연극,146,1233,2216,5314,145560100,7530,20230130
연극,154,1317,3137,7005,220364090,10142,20230131
연극,152,1425,4539,9541,434123920,14080,20230201
연극,162,1420,3934,8825,310135400,12759,20230202
연극,171,1385,3521,8101,222061900,11622,20230203
연극,153,1241,4101,7676,205894000,11777,20230204
연극,149,1214,3094,5961,159956400,9055,20230205
연극,149,1212,4839,4704,140058970,9543,20230206
연극,152,1284,3130,6191,171720950,9321,20230207
연극,162,1252,3181,7018,173044320,10199,20230208
연극,175,1326,4240,11172,232136152,15412,20230209
연극,183,1354,3524,7780,209297720,11304,20230210
연극,175,1312,4090,12271,184793320,16361,20230211
연극,159,1216,3336,6028,169789350,9364,20230212
연극,160,1227,2716,5373,150574570,8089,20230213
연극,176,1342,5566,13802,442221800,19368,20230214
연극,181,1344,4555,9878,447786482,14433,20230215
연극,188,1336,4886,8654,373842960,13540,20230216
연극,192,1343,4557,7975,230784510,12532,20230217
연극,187,1235,4257,6773,201409662,11030,20230218
연극,184,1161,3024,5675,159246030,8699,20230219
연극,167,1178,2413,5030,130260770,7443,20230220
연극,186,1238,4153,10030,375803430,14183,20230221
연극,196,1315,3503,6913,201463442,10416,20230222
연극,197,1297,4294,7136,186709960,11430,20230223
연극,205,1264,3804,8497,168686520,12301,20230224
연극,193,1149,3417,6518,175556030,9935,20230225
연극,179,1076,2355,6249,152326220,8604,20230226
연극,180,1108,2746,5737,142510495,8483,20230227
연극,192,1124,2732,6751,186831920,9483,20230228
연극,180,1227,2726,6107,156899310,8833,20230301
연극,195,1262,3749,5335,149024240,9084,20230302
연극,202,1223,2912,5421,154558140,8333,20230303
연극,192,1161,2622,6356,163673980,8978,20230304
연극,179,1082,2260,4495,131840440,6755,20230305
연극,177,1133,2477,5413,125558880,7890,20230306
연극,189,1212,5646,8251,328095290,13897,20230307
연극,199,1224,3517,4982,122484160,8499,20230308
연극,194,1258,3579,11017,172000130,14596,20230309
연극,214,1271,3649,7067,172659900,10716,20230310
연극,191,1102,2335,5925,139598200,8260,20230311
연극,173,1068,2230,4895,122281500,7125,20230312
연극,191,1172,3085,4784,132571210,7869,20230313
연극,197,1235,3313,6307,231385140,9620,20230314
연극,204,1276,3337,6695,199000510,10032,20230315
연극,207,1382,4189,10273,180204520,14462,20230316
연극,208,1272,3238,7166,172293170,10404,20230317
연극,202,1198,2565,6890,159340570,9455,20230318
연극,195,1102,2312,4880,131433250,7192,20230319
연극,207,1213,2946,3962,116521290,6908,20230320
연극,205,1221,3001,5075,120993460,8076,20230321
연극,218,1274,2875,8189,147442570,11064,20230322
연극,220,1214,2699,9170,136409330,11869,20230323
연극,232,1288,3729,7445,173665570,11174,20230324
연극,208,1113,2270,6981,200791300,9251,20230325
연극,218,1049,3589,9996,490616874,13585,20230326
연극,199,1122,3085,7909,300466120,10994,20230327
연극,219,1195,3521,9706,288273541,13227,20230328
연극,207,1166,3608,6796,222619450,10404,20230329
연극,216,1294,5314,12302,519251500,17616,20230330
연극,232,1262,3563,8256,178826351,11819,20230331
연극,207,1213,3009,7047,172550071,10056,20230401
연극,190,1119,2233,4360,113578271,6593,20230402
연극,210,1239,2642,5744,132620121,8386,20230403
연극,215,1249,3677,6043,140063190,9720,20230404
연극,223,1341,2703,5790,144074913,8493,20230405
연극,232,1429,3729,12647,199045280,16376,20230406
연극,227,1351,3157,8970,172872600,12127,20230407
연극,219,1277,2965,10294,159250050,13259,20230408
연극,205,1237,3939,5388,127121700,9327,20230409
연극,203,1246,2521,4785,118723560,7306,20230410
연극,211,1288,2773,5829,123806820,8602,20230411
연극,208,1313,3207,6649,126379030,9856,20230412
연극,209,1324,3487,7534,149011480,11021,20230413
연극,234,1454,3526,14525,193436090,18051,20230414
연극,214,1247,3140,6465,124334450,9605,20230415
연극,210,1194,2436,4800,105204881,7236,20230416
연극,207,1309,2253,8135,110949750,10388,20230417
연극,222,1376,2717,7671,175147260,10388,20230418
연극,231,1355,2739,7219,171022910,9958,20230419
연극,236,1419,3421,6183,135169140,9604,20230420
연극,237,1415,3441,7233,145964530,10674,20230421
연극,207,1238,3083,6342,126245960,9425,20230422
연극,197,1240,2465,5226,108680720,7691,20230423
연극,206,1361,2561,4962,102427950,7523,20230424
연극,227,1466,5594,7841,171537280,13435,20230425
연극,240,1504,4469,8925,278362860,13394,20230426
연극,235,1504,3748,9028,215708100,12776,20230427
연극,255,1516,4473,8698,188255371,13171,20230428
연극,230,1394,3878,8039,171370841,11917,20230429
연극,211,1274,3097,6850,168924062,9947,20230430
연극,231,1401,4291,5415,164401140,9706,20230501
연극,235,1606,3413,6730,170045760,10143,20230502
연극,246,1544,4308,8623,218719699,12931,20230503
연극,251,1591,4329,8447,214148180,12776,20230504
연극,236,1441,3701,8140,216338280,11841,20230505
연극,227,1328,3169,6170,160502470,9339,20230506
연극,207,1205,2519,4315,117328701,6834,20230507
연극,212,1302,2321,6134,124609120,8455,20230508
연극,241,1422,3840,8100,123383500,11940,20230509
연극,241,1434,3218,10670,260999561,13888,20230510
연극,258,1435,3155,7234,163838470,10389,20230511
연극,246,1374,4613,9061,264870461,13674,20230512
연극,237,1254,3066,6353,150272300,9419,20230513
연극,217,1189,3442,5049,122872010,8491,20230514
연극,231,1283,2110,5647,120806981,7757,20230515
연극,233,1433,7062,13777,365219669,20839,20230516
연극,234,1398,4059,5827,123035980,9886,20230517
연극,250,1439,3794,7826,225767941,11620,20230518
연극,237,1409,6263,12460,525994131,18723,20230519
연극,234,1302,4308,6375,150233880,10683,20230520
연극,223,1187,2882,4677,115844680,7559,20230521
연극,229,1358,2601,5931,112379680,8532,20230522
연극,235,1420,3619,6933,169289750,10552,20230523
연극,246,1405,3891,6599,165166980,10490,20230524
연극,253,1484,4234,8550,208989915,12784,20230525
연극,258,1422,4341,9666,197118980,14007,20230526
연극,238,1308,3453,8195,178041360,11648,20230527
연극,218,1124,2612,5972,142882120,8584,20230528
연극,229,1197,2338,4988,115832050,7326,20230529
연극,235,1296,3841,8677,136208400,12518,20230530
연극,242,1318,2996,6021,208180400,9017,20230531
연극,273,1531,3327,6168,138431700,9495,20230601
연극,275,1456,3387,8308,168388530,11695,20230602
연극,249,1228,2680,6123,138062860,8803,20230603
연극,228,1165,2305,5322,116768980,7627,20230604
연극,236,1246,2224,6191,122851309,8415,20230605
연극,237,1183,2594,5302,148065271,7896,20230606
연극,256,1312,2506,6195,142028051,8701,20230607
연극,260,1366,3238,12425,232965760,15663,20230608
연극,260,1392,5937,11560,365884690,17497,20230609
연극,236,1143,3045,5845,126860150,8890,20230610
연극,220,1165,2778,4216,126252160,6994,20230611
연극,233,1265,2889,5011,126318620,7900,20230612
연극,234,1287,2490,8056,138204510,10546,20230613
연극,239,1289,2307,5170,105701350,7477,20230614
연극,230,1253,2375,5098,97662360,7473,20230615
연극,246,1365,3055,10005,108956300,13060,20230616
연극,233,1129,2419,4926,92538280,7345,20230617
연극,204,1059,1815,3859,77450140,5674,20230618
연극,226,1205,1744,5025,69451570,6769,20230619
연극,235,1218,2208,3816,73198030,6024,20230620
연극,220,1191,2427,7045,143080000,9472,20230621
연극,249,1338,3316,7004,173527256,10320,20230622
연극,257,1388,2967,15041,169848450,18008,20230623
연극,222,1188,2930,6166,147656730,9096,20230624
연극,196,1083,2380,4356,104542850,6736,20230625
연극,215,1239,2285,4662,100495830,6947,20230626
연극,227,1316,2348,7508,180769120,9856,20230627
연극,246,1338,2504,7540,141450980,10044,20230628
연극,234,1358,2542,5963,130175830,8505,20230629
연극,238,1446,3252,6489,142928970,9741,20230630
연극,232,1386,2592,6679,149959430,9271,20230701
연극,211,1282,2245,5564,112480002,7809,20230702
연극,228,1366,1937,6129,96430080,8066,20230703
연극,236,1412,5594,10298,382390782,15892,20230704
연극,242,1508,4236,11209,376508690,15445,20230705
연극,239,1459,3657,12830,239907370,16487,20230706
연극,252,1481,3990,10031,230782970,14021,20230707
연극,234,1348,3633,9134,235564300,12767,20230708
연극,217,1335,2758,6218,179603033,8976,20230709
연극,232,1425,2753,6235,144671792,8988,20230710
연극,229,1377,2851,4789,125092852,7640,20230711
연극,232,1387,2410,5808,128650600,8218,20230712
연극,237,1473,2383,5532,121412905,7915,20230713
연극,242,1524,3182,13257,247505760,16439,20230714
연극,238,1341,3175,6804,165044230,9979,20230715
연극,229,1343,2630,6630,132725021,9260,20230716
연극,226,1405,2854,5226,105416041,8080,20230717
연극,226,1458,5533,7379,146640242,12912,20230718
연극,240,1531,3553,7771,217418012,11324,20230719
연극,249,1520,3323,7478,180945680,10801,20230720
연극,271,1514,5247,5475,51934931,10722,20230721
연극,240,1412,4223,5879,130118421,10102,20230722
연극,221,1363,2600,5901,131703861,8501,20230723
연극,225,1486,3114,7294,127138882,10408,20230724
연극,248,1584,3760,10427,179870291,14187,20230725
연극,252,1508,3076,7854,171812468,10930,20230726
연극,243,1545,3977,9568,230597532,13545,20230727
연극,255,1562,4134,9245,196204174,13379,20230728
연극,231,1412,4247,7177,171102380,11424,20230729
연극,213,1364,3000,6371,145000890,9371,20230730
연극,218,1474,3907,6637,138225336,10544,20230731
연극,236,1719,4043,9540,202459880,13583,20230801
연극,235,1692,3528,9370,189870300,12898,20230802
연극,234,1605,4126,8306,243738102,12432,20230803
연극,243,1526,4423,6392,165477791,10815,20230804
연극,241,1372,3605,8684,144773674,12289,20230805
연극,214,1346,2489,5145,126658210,7634,20230806
연극,235,1514,2894,4835,110742280,7729,20230807
연극,239,1458,3679,6771,129160090,10450,20230808
연극,256,1569,4661,9135,112604441,13796,20230809
연극,259,1534,3645,6713,120631929,10358,20230810
연극,274,1595,4394,7312,167037940,11706,20230811
연극,243,1380,3331,7237,156039606,10568,20230812
연극,231,1328,2902,7466,138310372,10368,20230813
연극,245,1385,2735,8713,146606710,11448,20230814
연극,234,1371,3873,9630,171550311,13503,20230815
연극,257,1478,3100,5487,99459094,8587,20230816
연극,265,1509,3888,9074,155878800,12962,20230817
연극,277,1493,3537,10796,126605060,14333,20230818
연극,239,1273,3930,5101,123393792,9031,20230819
연극,234,1186,3225,3786,96235460,7011,20230820
연극,250,1331,2708,5358,116797480,8066,20230821
연극,260,1331,2804,4956,120617170,7760,20230822
연극,274,1403,3399,6023,209051200,9422,20230823
연극,266,1370,2971,6743,149392580,9714,20230824
연극,282,1375,3432,6507,132807540,9939,20230825
연극,241,1239,4038,5510,132261720,9548,20230826
연극,253,1204,3366,4094,109981310,7460,20230827
연극,233,1237,2548,5010,97052190,7558,20230828
연극,240,1365,2646,9622,121665070,12268,20230829
연극,261,1308,3047,7014,131507190,10061,20230830
연극,258,1388,2904,7773,118232470,10677,20230831
연극,275,1440,3895,8521,168042160,12416,20230901
연극,246,1215,3080,6895,135083360,9975,20230902
연극,228,1185,2303,5607,118448850,7910,20230903
연극,240,1245,1988,4391,90850910,6379,20230904
연극,247,1239,2065,4812,108510850,6877,20230905
연극,257,1295,2918,5334,103971300,8252,20230906
연극,249,1242,2290,7303,107547110,9593,20230907
연극,269,1335,3521,10992,139596790,14513,20230908
연극,242,1144,3044,6676,129503140,9720,20230909
연극,224,1123,2395,4824,104956550,7219,20230910
연극,244,1158,1776,5386,109580900,7162,20230911
연극,259,1323,2021,10364,175380690,12385,20230912
연극,247,1238,2683,4074,49574370,6757,20230913
연극,268,1303,2908,6086,155866010,8994,20230914
연극,263,1260,2406,6171,130241640,8577,20230915
연극,244,1071,2334,5834,120768880,8168,20230916
연극,240,1066,1929,4612,98485580,6541,20230917
연극,241,1141,1840,4876,97691910,6716,20230918
연극,241,1307,1965,10823,130655680,12788,20230919
연극,249,1264,2201,6427,113057020,8628,20230920
연극,260,1285,2475,6618,120803130,9093,20230921
연극,280,1248,2873,5988,122995530,8861,20230922
연극,242,1107,2868,8339,118788520,11207,20230923
연극,230,1052,2244,4375,100963700,6619,20230924
연극,235,1223,1515,9872,84080660,11387,20230925
연극,249,1269,2588,5289,107670840,7877,20230926
연극,240,1314,2006,7846,107848560,9852,20230927
연극,210,1078,2111,3965,98099650,6076,20230928
연극,208,999,1760,4097,96798220,5857,20230929
연극,214,1064,2386,5439,122730190,7825,20230930
연극,205,1104,2385,6120,133353520,8505,20231001
연극,223,1173,2767,5756,124823300,8523,20231002
연극,228,1175,2255,3726,93862360,5981,20231003
연극,262,1295,2536,6910,100412600,9446,20231004
연극,263,1308,2355,5360,112797220,7715,20231005
연극,293,1342,2756,5771,116985060,8527,20231006
연극,268,1125,3586,4657,104356600,8243,20231007
연극,237,1040,2792,4958,109563930,7750,20231008
연극,240,1050,2570,3290,81383480,5860,20231009
연극,260,1268,1493,8374,89110320,9867,20231010
연극,269,1240,2000,5203,96008460,7203,20231011
연극,275,1345,3127,6059,120672710,9186,20231012
연극,274,1285,3121,7065,117783170,10186,20231013
연극,255,1075,3321,4843,107376400,8164,20231014
연극,297,1067,2463,3365,86755640,5828,20231015
연극,263,1177,1778,5085,102424110,6863,20231016
연극,290,1295,2256,9394,98182100,11650,20231017
연극,267,1321,2756,5458,115573370,8214,20231018
연극,284,1370,2845,5924,124588200,8769,20231019
연극,282,1321,7308,9165,272933112,16473,20231020
연극,253,1126,4081,4628,117085000,8709,20231021
연극,247,1087,2586,3845,92683770,6431,20231022
연극,310,1329,2347,6301,102889610,8648,20231023
연극,276,1304,3126,6585,118665270,9711,20231024
연극,288,1454,3594,11199,251862280,14793,20231025
연극,329,1539,3630,12768,161386350,16398,20231026
연극,293,1443,4119,9358,216148250,13477,20231027
연극,267,1230,4897,5420,143611260,10317,20231028
연극,266,1167,3194,4521,123065280,7715,20231029
연극,290,1345,2363,11154,164413100,13517,20231030
연극,295,1444,2327,9284,127180020,11611,20231031
연극,305,1558,3162,6797,142789470,9959,20231101
연극,298,1540,4570,6367,162744710,10937,20231102
연극,291,1475,4423,10009,201599050,14432,20231103
연극,266,1280,3686,6665,156212770,10351,20231104
연극,259,1235,2862,4956,127436530,7818,20231105
연극,256,1418,4625,7746,242521710,12371,20231106
연극,274,1446,4011,8210,199124410,12221,20231107
연극,289,1510,3261,7814,189239310,11075,20231108
연극,276,1536,3598,11542,159535260,15140,20231109
연극,291,1542,4030,8808,167659620,12838,20231110
연극,269,1348,3753,6138,135455990,9891,20231111
연극,272,1326,3456,5145,117272980,8601,20231112
연극,287,1444,2184,5131,117739620,7315,20231113
연극,276,1556,2556,6471,139681330,9027,20231114
연극,293,1622,2968,10552,143145300,13520,20231115
연극,299,1715,4225,13481,142927000,17706,20231116
연극,306,1638,3438,8057,150531300,11495,20231117
연극,275,1443,4086,6575,139802250,10661,20231118
연극,259,1422,2840,4851,114795780,7691,20231119
연극,263,1618,2402,5970,157508840,8372,20231120
연극,267,1642,2779,7080,149246470,9859,20231121
연극,276,1659,3417,7334,129167350,10751,20231122
연극,283,1680,6584,9738,291539300,16322,20231123
연극,287,1675,4893,7998,228608150,12891,20231124
연극,268,1458,3767,5355,131676510,9122,20231125
연극,243,1479,3073,4318,118609740,7391,20231126
연극,243,1654,2652,6708,179743340,9360,20231127
연극,250,1779,3370,15335,222546610,18705,20231128
연극,257,1785,3290,10021,170763680,13311,20231129
연극,257,1809,4174,7103,168261220,11277,20231130
연극,266,1902,4555,8628,201289380,13183,20231201
연극,244,1686,4047,6354,173526020,10401,20231202
연극,237,1669,3325,5365,154369740,8690,20231203
연극,233,1789,2843,6386,178241960,9229,20231204
연극,240,1796,5214,6451,166068950,11665,20231205
연극,257,1882,3856,6137,169465190,9993,20231206
연극,264,1952,5041,14287,353334354,19328,20231207
연극,267,1918,4758,9978,265739160,14736,20231208
연극,255,1717,5887,6418,212259470,12305,20231209
연극,238,1749,4625,6410,217072560,11035,20231210
연극,234,1864,3806,6880,182739320,10686,20231211
연극,233,1869,3954,6184,182736590,10138,20231212
연극,234,1882,6601,12365,459299880,18966,20231213
연극,244,1935,4683,7837,232732000,12520,20231214
연극,238,1979,6452,9495,287106070,15947,20231215
연극,222,1811,5706,6761,216150530,12467,20231216
연극,198,1814,4228,12393,204685570,16621,20231217
연극,212,1830,4119,7080,206827070,11199,20231218
연극,211,1836,4416,8250,276348510,12666,20231219
연극,220,1827,4796,7408,208210870,12204,20231220
연극,230,1871,7363,10612,389749380,17975,20231221
연극,235,1907,4471,8133,233242000,12604,20231222
연극,238,1814,5926,9323,277938210,15249,20231223
연극,199,1511,4686,9296,281165140,13982,20231224
연극,211,1424,4108,5811,187275090,9919,20231225
연극,181,1466,3904,6162,162390140,10066,20231226
연극,192,1445,3942,6389,165159440,10331,20231227
연극,205,1537,3981,8087,175032210,12068,20231228
연극,205,1513,7312,10965,395815850,18277,20231229
연극,182,1384,4620,6484,199176420,11104,20231230
연극,179,1282,4444,6260,170302860,10704,20231231
연극,156,1302,2274,5124,148317300,7398,20240101
연극,154,1434,2206,9893,128621810,12099,20240102
연극,162,1532,2743,8871,161763900,11614,20240103
연극,167,1470,3000,8137,255027280,11137,20240104
연극,172,1474,3510,8251,255299660,11761,20240105
연극,167,1328,3938,7052,203489040,10990,20240106
연극,167,1397,3572,6715,181465440,10287,20240107
연극,150,1407,2535,6967,180496210,9502,20240108
연극,158,1480,6671,11595,410283360,18266,20240109
연극,165,1607,4296,7189,180047210,11485,20240110
연극,165,1600,4258,12315,252914020,16573,20240111
연극,172,1511,4979,8760,229265600,13739,20240112
연극,162,1415,4590,7334,179505420,11924,20240113
연극,160,1366,3535,6015,154959300,9550,20240114
연극,153,1404,6977,8243,284329270,15220,20240115
연극,163,1485,3898,7131,169640840,11029,20240116
연극,163,1483,4069,6382,155976980,10451,20240117
연극,172,1547,5504,9716,223583250,15220,20240118
연극,170,1514,4264,7515,212894075,11779,20240119
연극,166,1375,4919,6383,195009230,11302,20240120
연극,151,1329,3885,5556,156994550,9441,20240121
연극,161,1388,3933,7392,216637360,11325,20240122
연극,170,1541,3273,10674,166419630,13947,20240123
연극,178,1592,4889,7801,224582780,12690,20240124
연극,172,1601,3472,10212,144263300,13684,20240125
연극,188,1512,5627,8075,254019970,13702,20240126
연극,180,1399,3841,6353,168014760,10194,20240127
연극,161,1341,3122,5025,132006950,8147,20240128
연극,163,1374,2457,4911,107940590,7368,20240129
연극,161,1434,3372,9511,317687780,12883,20240130
연극,171,1626,6400,11038,369197500,17438,20240131
연극,170,1608,4292,7612,207555570,11904,20240201
연극,171,1554,4235,7841,230034280,12076,20240202
연극,159,1364,4050,5696,169341450,9746,20240203
연극,154,1402,3897,5054,130233780,8951,20240204
연극,158,1411,2459,4482,116506630,6941,20240205
연극,161,1443,3443,8905,165350410,12348,20240206
연극,165,1399,3870,5551,199965410,9421,20240207
연극,174,1507,3759,10830,197148930,14589,20240208
연극,157,1314,3376,5491,147130200,8867,20240209
연극,160,1226,3348,4575,137924390,7923,20240210
연극,158,1284,3290,5775,157333650,9065,20240211
연극,159,1321,2942,5803,148297320,8745,20240212
연극,178,1503,5396,9233,220373260,14629,20240213
연극,188,1563,4213,8233,193365000,12446,20240214
연극,207,1629,4058,7741,183590330,11799,20240215
연극,205,1573,4214,6938,188628030,11152,20240216
연극,199,1407,4213,6392,176192190,10605,20240217
연극,192,1327,3041,4903,136500970,7944,20240218
연극,184,1406,3054,10446,223162320,13500,20240219
연극,192,1487,7041,15504,721696980,22545,20240220
연극,202,1530,3799,8376,271762660,12175,20240221
연극,209,1458,3736,8589,307291280,12325,20240222
연극,209,1551,6276,12787,444452440,19063,20240223
연극,195,1428,4047,8894,210522870,12941,20240224
연극,182,1374,3367,5938,168505490,9305,20240225
연극,189,1453,4671,10823,221852050,15494,20240226
연극,195,1453,3161,7431,196851740,10592,20240227
연극,209,1543,4567,10283,195862020,14850,20240228
연극,212,1501,6595,7583,190530220,14178,20240229
연극,214,1469,4241,7766,187454760,12007,20240301
연극,194,1246,3368,5772,147388210,9140,20240302
연극,194,1195,2437,3541,105626760,5978,20240303
연극,200,1292,2016,3636,96736450,5652,20240304
연극,203,1361,2642,5807,134711800,8449,20240305
연극,206,1406,4062,7660,191567240,11722,20240306
연극,222,1455,3446,10907,208662560,14353,20240307
연극,227,1524,2971,6978,164451299,9949,20240308
연극,208,1300,4081,5432,153479160,9513,20240309
연극,207,1346,2826,4392,125328250,7218,20240310
연극,221,1439,2609,5498,128944820,8107,20240311
연극,223,1478,6535,11649,343952980,18184,20240312
연극,229,1544,3788,6382,177208060,10170,20240313
연극,220,1483,3463,7954,251269890,11417,20240314
연극,245,1523,3685,7591,226817970,11276,20240315
연극,221,1359,3705,5998,162780710,9703,20240316
연극,221,1360,3247,4906,149565280,8153,20240317
연극,214,1424,2809,4990,137054915,7799,20240318
연극,228,1421,3684,6304,193667170,9988,20240319
연극,240,1559,3095,5413,148279720,8508,20240320
연극,240,1606,4059,10558,178524890,14617,20240321
연극,240,1653,5386,9188,235914660,14574,20240322
연극,236,1452,4046,6503,164259170,10549,20240323
연극,205,1327,3243,4241,119306992,7484,20240324
연극,219,1479,2682,4601,110476140,7283,20240325
연극,218,1566,3349,11230,149266110,14579,20240326
연극,233,1479,3858,5483,154564380,9341,20240327
연극,234,1535,3515,8396,132733677,11911,20240328
연극,245,1446,3727,6887,138629520,10614,20240329
연극,234,1432,3254,5124,135346100,8378,20240330
연극,216,1370,2940,3874,101652730,6814,20240331
연극,214,1496,3307,4040,116283850,7347,20240401
연극,225,1499,5916,10416,283764470,16332,20240402
연극,225,1533,4082,5312,126865310,9394,20240403
연극,228,1512,3766,4629,127683950,8395,20240404
연극,227,1442,3003,5454,138633840,8457,20240405
연극,209,1329,3459,5147,150796840,8606,20240406
연극,206,1283,2923,4487,124882880,7410,20240407
연극,223,1380,2817,6139,222104420,8956,20240408
연극,232,1488,3580,9866,192726660,13446,20240409
연극,219,1421,3548,4783,147463580,8331,20240410
연극,240,1536,4916,7672,235621900,12588,20240411
연극,247,1478,3584,8119,220509630,11703,20240412
연극,238,1356,3675,6749,173592640,10424,20240413
연극,224,1284,2826,5147,121624720,7973,20240414
연극,256,1464,2644,6317,146047260,8961,20240415
연극,254,1492,2704,5064,127990550,7768,20240416
연극,271,1662,3517,9597,137895260,13114,20240417
연극,266,1482,3541,7521,155309800,11062,20240418
연극,280,1599,3862,7230,180130850,11092,20240419
연극,246,1355,3504,5884,157963800,9388,20240420
연극,255,1324,2947,4851,132794340,7798,20240421
연극,243,1341,2210,5085,96421925,7295,20240422
연극,256,1482,3585,8444,175675685,12029,20240423
연극,253,1468,4125,6889,167125627,11014,20240424
연극,270,1597,3635,12618,219534500,16253,20240425
연극,267,1644,6291,15686,873812920,21977,20240426
연극,242,1506,12599,5675,283855130,18274,20240427
연극,242,1423,3698,5497,196026120,9195,20240428
연극,225,1484,2388,5357,176067426,7745,20240429
연극,256,1637,3465,11683,248583554,15148,20240430
연극,234,1674,4199,8416,202296180,12615,20240501
연극,254,1761,7235,12628,439875640,19863,20240502
연극,269,1700,6075,12351,322832180,18426,20240503
연극,245,1497,4389,7458,224851141,11847,20240504
연극,246,1415,5106,6554,185383300,11660,20240505
연극,220,1388,3359,4559,144971910,7918,20240506
연극,234,1498,3156,5781,133540662,8937,20240507
연극,247,1554,3050,9135,159027090,12185,20240508
연극,257,1572,3689,7335,171716470,11024,20240509
연극,264,1577,4202,8994,229914652,13196,20240510
연극,255,1399,3684,6413,184688340,10097,20240511
연극,236,1375,3291,4865,141755890,8156,20240512
연극,239,1399,2303,6833,144373900,9136,20240513
연극,253,1489,5178,14369,612768130,19547,20240514
연극,246,1371,3817,5853,201079125,9670,20240515
연극,263,1485,4475,6160,178013230,10635,20240516
연극,261,1571,4041,11002,193265220,15043,20240517
연극,247,1299,3794,5156,168774820,8950,20240518
연극,229,1253,2956,4647,140862550,7603,20240519
연극,244,1378,6251,9018,321447870,15269,20240520
연극,246,1482,3389,6836,160733800,10225,20240521
연극,263,1460,3460,7521,160976350,10981,20240522
연극,259,1413,3782,6916,168434900,10698,20240523
연극,265,1462,3901,7134,165789025,11035,20240524
연극,246,1317,3686,5059,145137670,8745,20240525
연극,239,1342,3336,5445,137466590,8781,20240526
연극,242,1401,2585,4255,95472050,6840,20240527
연극,262,1562,5502,16446,568819540,21948,20240528
연극,275,1510,4672,16015,249347050,20687,20240529
연극,276,1575,4402,6775,187257280,11177,20240530
연극,281,1597,4297,9188,270689220,13485,20240531
연극,263,1526,3835,7076,210771910,10911,20240601
연극,257,1454,3823,5576,152817620,9399,20240602
연극,273,1570,2650,5673,158823940,8323,20240603
연극,278,1631,3993,10900,217931332,14893,20240604
연극,295,1639,4531,9333,235087480,13864,20240605
연극,276,1510,4100,6719,210053640,10819,20240606
연극,306,1569,4382,9819,262429100,14201,20240607
연극,276,1361,3698,6317,193712050,10015,20240608
연극,274,1288,3223,5488,157509450,8711,20240609
연극,267,1525,4155,7374,185463200,11529,20240610
연극,291,1600,3924,8052,173180250,11976,20240611
연극,284,1612,3916,9558,186104050,13474,20240612
연극,308,1635,4304,8283,167588500,12587,20240613
연극,307,1625,4369,7569,184937350,11938,20240614
연극,294,1454,3445,6490,165639072,9935,20240615
연극,260,1418,3091,4951,145045050,8042,20240616
연극,284,1499,3473,6760,136661610,10233,20240617
연극,280,1593,3421,6939,156371900,10360,20240618
연극,292,1605,3643,5720,147649220,9363,20240619
연극,311,1687,5183,12172,248909340,17355,20240620
연극,316,1650,4681,10828,240522460,15509,20240621
연극,298,1594,3749,7345,185588170,11094,20240622
연극,275,1448,3358,5819,165175770,9177,20240623
연극,299,1547,5663,10146,301857650,15809,20240624
연극,300,1713,4666,12234,273323000,16900,20240625
연극,304,1765,4898,12283,197082600,17181,20240626
연극,294,1719,4944,8880,166827850,13824,20240627
연극,301,1631,4035,11084,168457330,15119,20240628
연극,270,1515,7419,5440,167833150,12859,20240629
연극,256,1436,4403,3783,139019040,8186,20240630
연극,281,1658,3269,9489,239973570,12758,20240701
연극,297,1655,8488,15026,670761550,23514,20240702
연극,286,1752,8899,16405,672317050,25304,20240703
연극,292,1755,4995,14329,387439750,19324,20240704
연극,299,1735,5636,11277,310815380,16913,20240705
연극,296,1590,4695,8263,300588760,12958,20240706
연극,268,1545,3746,6384,239848890,10130,20240707
연극,292,1581,3346,6584,199902860,9930,20240708
연극,288,1659,4546,5955,94365970,10501,20240709
연극,290,1779,6076,12261,199041750,18337,20240710
연극,292,1731,4922,10193,242250290,15115,20240711
연극,309,1790,8802,13420,445531230,22222,20240712
연극,285,1604,4728,7696,228764720,12424,20240713
연극,259,1547,3694,5974,165596870,9668,20240714
연극,288,1712,3515,8015,213573130,11530,20240715
연극,301,1719,4051,10529,156205210,14580,20240716
연극,314,1804,5522,6020,151192760,11542,20240717
연극,299,1749,4878,7509,171387920,12387,20240718
연극,325,1962,7451,12733,476470910,20184,20240719
연극,288,1679,4614,7809,213419120,12423,20240720
연극,287,1642,4089,6856,178252330,10945,20240721
연극,307,1836,3636,7803,170401910,11439,20240722
연극,310,1972,5671,11385,291793840,17056,20240723
연극,328,2005,4910,13817,247201350,18727,20240724
연극,324,2070,6231,16342,311130830,22573,20240725
연극,326,2110,5362,10562,244265600,15924,20240726
연극,310,1812,4536,8452,204593400,12988,20240727
연극,277,1730,3931,8571,176903650,12502,20240728
연극,280,1778,3278,7869,172780150,11147,20240729
연극,290,1872,4135,8633,182857950,12768,20240730
연극,287,1980,5463,8568,198779450,14031,20240731
연극,312,2005,7381,12574,360787450,19955,20240801
연극,298,1853,5475,10114,211620500,15589,20240802
연극,274,1642,4573,7531,185611200,12104,20240803
연극,256,1583,3559,6128,168706550,9687,20240804
연극,273,1710,3125,6869,152189650,9994,20240805
연극,281,1868,6107,12313,381906400,18420,20240806
연극,284,1899,4918,10805,213205800,15723,20240807
연극,287,1893,5098,9963,238141550,15061,20240808
연극,309,1879,4916,10651,279023250,15567,20240809
연극,279,1648,3961,7592,191373850,11553,20240810
연극,271,1629,3673,5773,157099700,9446,20240811
연극,274,1713,3237,6414,159230150,9651,20240812
연극,283,1673,5459,9763,394924770,15222,20240813
연극,294,1803,5214,10369,204488300,15583,20240814
연극,278,1611,4142,7008,190771900,11150,20240815
연극,304,1731,5248,9719,211193700,14967,20240816
연극,291,1536,4088,6161,168008300,10249,20240817
연극,266,1477,2930,5375,149000250,8305,20240818
연극,283,1545,2757,6243,121486200,9000,20240819
연극,303,1657,3028,7212,146472700,10240,20240820
연극,291,1616,4019,7099,184191700,11118,20240821
연극,319,1699,4057,9914,156021700,13971,20240822
연극,324,1713,3800,8883,210703810,12683,20240823
연극,295,1500,4225,6751,167429900,10976,20240824
연극,270,1401,3092,5875,181956200,8967,20240825
연극,276,1460,2336,5319,131230400,7655,20240826
연극,298,1576,3463,7076,186204100,10539,20240827
연극,306,1611,4817,10860,154663150,15677,20240828
연극,298,1614,3383,12231,152801750,15614,20240829
연극,308,1549,4519,11564,306516250,16083,20240830
연극,282,1417,3833,6342,160298250,10175,20240831
연극,268,1409,3203,7651,138036150,10854,20240901
연극,282,1518,2657,6987,170603300,9644,20240902
연극,282,1551,3464,9018,199624600,12482,20240903
연극,288,1614,4111,6811,160079300,10922,20240904
연극,294,1661,3445,9684,401287350,13129,20240905
연극,295,1667,3983,10460,341952850,14443,20240906
연극,273,1487,3980,6935,209484250,10915,20240907
연극,258,1337,2493,5202,144826550,7695,20240908
연극,258,1432,3941,8529,259854500,12470,20240909
연극,273,1541,2977,11157,152012700,14134,20240910
연극,272,1516,3800,7396,160005230,11196,20240911
연극,278,1528,2879,7501,138375390,10380,20240912
연극,297,1635,3534,10797,143655720,14331,20240913
연극,252,1385,3342,5143,145607750,8485,20240914
연극,253,1218,2931,4948,132964470,7879,20240915
연극,228,1084,2692,3219,106713670,5911,20240916
연극,230,1039,2701,3183,96651370,5884,20240917
연극,260,1272,2838,4065,101226260,6903,20240918
연극,289,1504,3081,5519,126715040,8600,20240919
연극,310,1550,5400,4549,139009440,9949,20240920
연극,284,1384,3934,5454,129409850,9388,20240921
연극,268,1318,2298,4718,106440400,7016,20240922
연극,297,1447,2026,4958,105396510,6984,20240923
연극,312,1616,2967,7465,152506510,10432,20240924
연극,323,1684,3277,7280,140747680,10557,20240925
연극,328,1703,3837,10080,437901100,13917,20240926
연극,335,1795,4161,14773,423717730,18934,20240927
연극,306,1525,4175,6448,197850850,10623,20240928
연극,298,1479,2737,5650,145832750,8387,20240929
연극,310,1679,5068,9457,225668310,14525,20240930
연극,293,1728,3426,5961,147038310,9387,20241001
연극,335,1789,3933,9448,210918100,13381,20241002
연극,319,1580,4698,5542,135988440,10240,20241003
연극,336,1728,6422,11325,330560820,17747,20241004
연극,313,1506,5620,5215,156700100,10835,20241005
연극,285,1435,3405,4036,110135170,7441,20241006
연극,303,1512,2065,6393,128981020,8458,20241007
연극,315,1543,3676,8424,154290810,12100,20241008
연극,291,1487,4047,4779,130669672,8826,20241009
연극,322,1662,3694,10679,241515660,14373,20241010
연극,323,1635,3718,7381,165844350,11099,20241011
연극,316,1407,3973,5508,128502870,9481,20241012
연극,288,1303,2297,4340,102205420,6637,20241013
연극,312,1477,3270,8085,76554880,11355,20241014
연극,313,1505,3642,5132,105128970,8774,20241015
연극,321,1531,3996,8080,253357520,12076,20241016
연극,329,1588,4815,12306,313904800,17121,20241017
연극,337,1771,4446,9008,198725860,13454,20241018
연극,299,1489,5004,5752,150597750,10756,20241019
연극,279,1330,2697,4382,116757000,7079,20241020
연극,299,1457,4191,3208,3584790,7399,20241021
연극,296,1468,3370,5948,132640850,9318,20241022
연극,303,1553,5326,3246,43462950,8572,20241023
연극,315,1529,3800,9225,243884300,13025,20241024
연극,324,1668,6613,9497,264825970,16110,20241025
연극,300,1425,3867,4931,154970100,8798,20241026
연극,264,1288,2394,3948,104353380,6342,20241027
연극,266,1550,2205,14962,107050772,17167,20241028
연극,279,1528,3821,5776,120890020,9597,20241029
연극,281,1607,3720,7296,196538100,11016,20241030
연극,288,1651,4398,7514,209363300,11912,20241031
연극,309,1811,4165,13221,355114698,17386,20241101
연극,288,1486,3441,7377,190315520,10818,20241102
연극,266,1424,2621,4728,133037040,7349,20241103
연극,277,1521,2696,6267,129844424,8963,20241104
연극,264,1563,3100,7152,255239140,10252,20241105
연극,261,1658,4347,8367,279167050,12714,20241106
연극,283,1811,3218,11521,200090760,14739,20241107
연극,305,1846,7972,16409,363470760,24381,20241108
연극,278,1579,4151,5260,151151690,9411,20241109
연극,280,1495,2956,4801,130022050,7757,20241110
연극,285,1636,3088,6275,148233770,9363,20241111
연극,314,1681,3051,6178,154221580,9229,20241112
연극,303,1762,3551,6340,146077930,9891,20241113
연극,315,1794,3705,5972,142298750,9677,20241114
연극,324,1956,4238,8851,185624290,13089,20241115
연극,307,1653,3912,7158,172755600,11070,20241116
연극,267,1521,2685,5914,136659150,8599,20241117
연극,268,1716,2076,6151,141418100,8227,20241118
연극,280,1827,4763,9481,231358300,14244,20241119
연극,299,1994,5405,9395,196029760,14800,20241120
연극,301,1947,4755,7497,193868052,12252,20241121
연극,309,2062,7095,11984,293876420,19079,20241122
연극,285,1757,3959,7276,175014800,11235,20241123
연극,274,1701,3021,5455,147468970,8476,20241124
연극,267,1883,4340,9873,298994350,14213,20241125
연극,273,1910,4569,7628,209049550,12197,20241126
연극,287,1954,4663,8964,238621550,13627,20241127
연극,288,1885,4917,6726,197724020,11643,20241128
연극,301,2073,6876,17415,391186233,24291,20241129
연극,290,1889,4757,7053,214622700,11810,20241130
연극,276,2006,3283,7734,218298550,11017,20241201
연극,276,2174,3366,9236,220966270,12602,20241202
연극,288,2121,4073,9159,218890800,13232,20241203
연극,281,2031,4364,7688,209631350,12052,20241204
연극,289,2149,4278,8223,208191330,12501,20241205
연극,288,1991,5627,7664,188752870,13291,20241206
연극,269,1826,4265,6014,163078400,10279,20241207
연극,247,1764,3346,5290,167165750,8636,20241208
연극,254,1905,2694,6382,165107400,9076,20241209
연극,262,2095,3835,11747,207630675,15582,20241210
연극,271,2083,6636,6840,187919000,13476,20241211
연극,268,2027,4119,6893,189694940,11012,20241212
연극,276,2033,4082,6855,202652920,10937,20241213
연극,247,1855,4628,6305,172636200,10933,20241214
연극,244,1920,3936,6016,191844265,9952,20241215
연극,248,2006,2949,6470,177699035,9419,20241216
연극,242,2062,3462,7972,208081090,11434,20241217
연극,250,2121,5072,8039,288921865,13111,20241218
연극,254,2189,5416,10123,391949465,15539,20241219
연극,251,2184,6301,12003,370462777,18304,20241220
연극,237,2004,5572,7622,255337530,13194,20241221
연극,218,2028,4460,12859,256260445,17319,20241222
연극,220,1990,5521,8895,265794520,14416,20241223
연극,229,2008,5608,9325,282690302,14933,20241224
연극,211,1804,5189,7856,249618789,13045,20241225
연극,205,1720,3820,7332,176759350,11152,20241226
연극,216,1818,8100,18264,546759790,26364,20241227
연극,205,1637,5228,5956,201909720,11184,20241228
연극,191,1481,3819,5642,163356372,9461,20241229
연극,170,1516,2772,4877,139321770,7649,20241230
연극,173,1559,3479,6021,194222220,9500,20241231
